questions	answers	gold
Who is the mother of the director of film Polish-Russian War (Film)?	[Final Answer]: Małgorzata Braunek	Małgorzata Braunek
Which film came out first, Blind Shaft or The Mask Of Fu Manchu?	[Final Answer]: Blind Shaft	The Mask Of Fu Manchu
When did John V, Prince Of Anhalt-Zerbst's father die?	[Final Answer]: 12 June 1516	12 June 1516
What is the award that the director of film Wearing Velvet Slippers Under A Golden Umbrella won?	[Final Answer]: Myanmar Motion Picture Academy Awards	Myanmar Motion Picture Academy Awards
Where was the director of film Ronnie Rocket born?	[Final Answer]: Missoula, Montana	Missoula, Montana
Who is Charles Bretagne Marie De La Trémoille's paternal grandfather?	[Final Answer]: Louis III de La Trémoille	Charles Armand René de La Trémoille
Where was the father of Ștefan I. Nenițescu born?	[Final Answer]: Bucharest	Galați
Are North Marion High School (Oregon) and Seoul High School both located in the same country?	[Final Answer]: Yes	no
Which film has the director who was born later, El Extraño Viaje or Love In Pawn?	[Final Answer]: El Extraño Viaje	El Extraño Viaje
Who is the maternal grandfather of Antiochus X Eusebes?	[Final Answer]: Cleopatra Selene	Ptolemy IX Lathyros
Which film has the director died first, Crimen A Las Tres or The Working Class Goes To Heaven?	[Final Answer]: Crimen A Las Tres	The Working Class Goes To Heaven
Which film has the director born first, Once A Gentleman or The Girl In White?	[Final Answer]: Once A Gentleman	Once A Gentleman
Which film has the director who died earlier, Il Seduttore or The Trial Of Joan Of Arc?	[Final Answer]: Il Seduttore	The Trial Of Joan Of Arc
Where was the director of film Thomas Jefferson (Film) born?	"[Final Answer]: The information provided does not state where the director of the film ""Thomas Jefferson"" (Film) was born."	Brooklyn
Why did Grand Duke Kirill Vladimirovich Of Russia's wife die?	[Final Answer]: Princess Victoria Melita of Saxe-Coburg and Gotha died after suffering a stroke while visiting her daughter Maria in Amorbach.	stroke
Where was the place of death of the director of film Beat Girl?	[Final Answer]: Nice	Nice
Who died first, Fleetwood Sheppard or George William Whitaker?	[Final Answer]: William Whitaker	Fleetwood Sheppard
Which film has the director born first, The Raven'S Dance or Keïta! L'Héritage Du Griot?	[Final Answer]: The Raven'S Dance	The Raven'S Dance
When did Jean Martin (Singer)'s husband die?	[Final Answer]: March 7, 1983.	1983
Which film has the director who died earlier, Tangled Destinies or The Daltons' Women?	[Final Answer]: Tangled Destinies	Tangled Destinies
Which film was released earlier, Moment Of Danger or The Ballad Of Josie?	[Final Answer]: Moment Of Danger	Moment Of Danger
What nationality is the director of film World And Time Enough?	[Final Answer]: American.	United States
Which film has the director died earlier, Poker In Bed or The Machine To Kill Bad People?	[Final Answer]: Poker In Bed. Giuliano Carnimeo died in 2016, while Roberto Rossellini died in 1977.	The Machine To Kill Bad People
Which film whose director is younger, Heads I Win, Tails You Lose or The Incredible Sarah?	[Final Answer]: Heads I Win, Tails You Lose.	Heads I Win, Tails You Lose
Who is Catherine Of Pomerania, Countess Palatine Of Neumarkt's father-in-law?	[Final Answer]: John, Count Palatine of Neumarkt	Rupert
Who is Marie Zéphyrine Of France's paternal grandmother?	[Final Answer]: Maria Josepha of Saxony.	Marie Leszczyńska
Which film has the director died earlier, Condemned Women or Faces In The Dark?	[Final Answer]: Faces In The Dark	Condemned Women
Who is the spouse of the director of film Eden And After?	[Final Answer]: Catherine Robbe-Grillet	Catherine Robbe-Grillet
Where was the place of death of Anastasia Of Serbia's husband?	[Final Answer]: Mount Athos	Hilandar
Are Fire In Hell and The Tiger: An Old Hunter'S Tale from the same country?	[Final Answer]: Yes	yes
Which film was released more recently, Lo Zappatore or Placer Sangriento?	[Final Answer]: Lo Zappatore.	Placer Sangriento
Was Şemsettin Baş or Gwenc'Hlan Le Scouëzec born first?	[Final Answer]: Gwenc'Hlan Le Scouëzec was born first. Gwenc'Hlan Le Scouëzec was born on November 11, 1929, while Şemsettin Baş was born on January 4, 1973.	Gwenc'Hlan Le Scouëzec
Which film has the director born later, Bhoomiyude Avakashikal or The Majesty Of The Law?	[Final Answer]: Bhoomiyude Avakashikal	Bhoomiyude Avakashikal
Who is Cornelia (Wife Of Caesar)'s child-in-law?	[Final Answer]: Flavius Eusebius	Pompey
Why did John Middleton Murry's wife die?	[Final Answer]: Mansfield was diagnosed with extrapulmonary tuberculosis in 1917; the disease claimed her life at the age of 34.	tuberculosis
Who is the paternal grandfather of Taj Al-Dawla?	[Final Answer]: Ashraf ibn Taj al- Dawla.	Rukn al-Dawla
Do both films Payment On Demand and My Cousin From Warsaw have the directors from the same country?	[Final Answer]: Yes, both Payment On Demand and My Cousin From Warsaw have directors from the same country – Germany. Curtis Bernhardt directed Payment On Demand, and Carl Boese directed My Cousin From Warsaw.	yes
What is the place of birth of the director of film And The Spring Comes?	[Final Answer]: Xi'an, Shaanxi	Xi'an
Who died first, Madame Pasca or James A. Donohoe?	[Final Answer]: Madame Pasca	Madame Pasca
Who was born later, D'Arcy Coulson or Thomas William Adams?	[Final Answer]: Thomas William Adams	D'Arcy Coulson
Are Simonds Catholic College and Saginaw High School (Texas) both located in the same country?	[Final Answer]: Yes	no
Which country Prince Nikolaus Wilhelm Of Nassau's mother is from?	[Final Answer]: Württemberg	German
Which film whose director was born first, 45 Fathers or The Intended?	[Final Answer]: 45 Fathers	45 Fathers
Who is the paternal grandfather of Alexandre Berthier, 3Rd Prince Of Wagram?	[Final Answer]: Louis- Alexandre Berthier	Louis-Alexandre Berthier
Where was the husband of Caterina Visconti born?	[Final Answer]: Forlì.	Pavia
Which film has the director who was born later, A Quiet Place In The Country or When Were You Born?	[Final Answer]: When Were You Born	A Quiet Place In The Country
Who was born first, John Beach or Gordon Persons?	[Final Answer]: Major John Beach	John Beach
Which film has the director born earlier, The House By The Cemetery or Charlie Chan In Honolulu?	[Final Answer]: The House by the Cemetery. Lucio Fulci was born in 1927, while Charlie Chan in Honolulu was released in 1939.	Charlie Chan In Honolulu
Who is the child of the director of film La Leona (Film)?	[Final Answer]: Víctor Bó	Víctor Bó
Who is Blanche Of Portugal (1259–1321)'s paternal grandmother?	[Final Answer]: Beatrice of Castile	Urraca of Castile
Who lived longer, Giuseppe Cesari or Nicos Poulantzas?	[Final Answer]: Giuseppe Cesari lived longer, from February 1568 – 3 July 1640, while Nicos Poulantzas died in 1979.	Giuseppe Cesari
Are director of film Nights On The Road and director of film Swann In Love (Film) from the same country?	[Final Answer]: Yes	yes
Who is older, Aryeh Ben-Eliezer or Jason Pociask?	[Final Answer]: Aryeh Ben-Eliezer	Aryeh Ben-Eliezer
Where does the director of film Man At Bath work at?	[Final Answer]: Switzerland	Cahiers du cinéma
Who is Arthur Gore, 2Nd Earl Of Arran's paternal grandfather?	[Final Answer]: Sir Arthur Gore, 1st Baronet	Sir Arthur Gore, 2nd Baronet
Are both Kaufland and Otrag located in the same country?	[Final Answer]: No. Kaufland is based in Germany, while OTRAG was a German company based in Stuttgart.	yes
Which film came out earlier, Aanaval Mothiram or Heroes Of The Street?	[Final Answer]: Aanaval Mothiram	Heroes Of The Street
Where was the father of Lord Patrick Crichton-Stuart born?	[Final Answer]: London	London
Which country the director of film Daadagiri is from?	[Final Answer]: India	Pakistan
Where was the wife of Douglas Leiterman born?	[Final Answer]: Berlin.	Winnipeg, Manitoba
What is the place of birth of the performer of song Who...?	[Final Answer]: Tokyo	Fukuoka
Where was the place of death of the director of film Mole Men Against The Son Of Hercules?	[Final Answer]: The information does not state the place of death of the director of Mole Men Against the Son of Hercules.	Roma
Where was the father of Alexandre Gaydamak born?	[Final Answer]: Moscow.	Moscow, USSR
Which film has the director who died earlier, Toen 'T Licht Verdween or Boum Sur Paris?	[Final Answer]: Toen 'T Licht Verdween	Toen 'T Licht Verdween
Who is Gaston, Duke Of Orléans's paternal grandmother?	[Final Answer]: Hannah Arnold, also known as Hannah Waterman King.	Jeanne d'Albret
Where was the director of film The Half-Way Girl born?	[Final Answer]: New York, New York	New York
Who is the father-in-law of Sophia Of Wittelsbach?	[Final Answer]: Hermann I	Louis II
Where was the place of death of Lambert I, Count Of Louvain's father?	[Final Answer]: Florennes	Bohemia
Where was the director of film Highway Dragnet born?	[Final Answer]: Nathan Juran	Gura Humorului
Where did Prince Gustav Of Thurn And Taxis (1848–1914)'s mother die?	[Final Answer]: Obermais, Meran	Meran
What is the award that the performer of song Sunday Papers earned?	[Final Answer]: 5 Grammy Award nominations.	Grammy
Which film has the director born first, Antonieta or Dodging The Dole?	[Final Answer]: Antonieta	Dodging The Dole
Are both Nikolsk Airport and Svobodny Airport located in the same country?	[Final Answer]: Yes	yes
Who is the maternal grandfather of Amadeus Vii, Count Of Savoy?	[Final Answer]: Peter I, Duke of Bourbon	Peter I
Are both businesses, Telus and Ztr Control Systems, located in the same country?	[Final Answer]: Yes.	yes
Do both films, Dial M For Murder and Marius (1931 Film), have the directors who are from the same country?	Yes, both films, Dial M for Murder and Marius (1931 Film), have directors who are from the same country. Alfred Hitchcock directed Dial M for Murder, and Alexander Korda directed Marius. Both directors are British. [Final Answer]: Yes	yes
Who is older, Dyson Parody or Gene Watson?	[Final Answer]: Gene Watson	Gene Watson
Are both directors of films The Princess Bride (Film) and I Never Sang For My Father from the same country?	[Final Answer]: Yes. Both directors of films The Princess Bride (Film) and I Never Sang For My Father, Rob Reiner and Gilbert Cates, are from the United States.	yes
When did Prince John Konstantinovich Of Russia's mother die?	[Final Answer]: 1927.	24 March 1927
Which country Audofleda's husband is from?	[Final Answer]: Ostrogoths.	Ostrogothic Kingdom
What is the place of birth of the director of film Letter To The King?	[Final Answer]: Hisham Zaman	Kurdish
Are both bands, Snowman (Band) and Jessamine (Band), from the same country?	[Final Answer]: No. Snowman was from Perth, Western Australia, while Jessamine was from Seattle, Washington.	no
Where was the performer of song God (John Lennon Song) born?	[Final Answer]: Liverpool	Liverpool
Which film has the director who died earlier, Captain Kidd And The Slave Girl or Relax Freddie?	[Final Answer]: Captain Kidd And The Slave Girl	Captain Kidd And The Slave Girl
Which song was released more recently, Go Ahead And Break My Heart or Knee Deep In My Heart?	[Final Answer]: Go Ahead And Break My Heart.	Go Ahead And Break My Heart
Which film has the director who died later, The Fatal Mistake or The Devil'S Hairpin?	[Final Answer]: The Fatal Mistake	The Devil'S Hairpin
Who is Maria Luisa Of Savoy's father-in-law?	[Final Answer]: Philip V	Louis, Grand Dauphin
Who is the paternal grandfather of Kujō Yoritsugu?	[Final Answer]: Kujō Michiie	Kujō Michiie
What is the place of birth of the director of film Marianela (1940 Film)?	[Final Answer]: Madrid	Madrid
Which film came out first, Repeated Absences or She Wore A Yellow Ribbon?	[Final Answer]: Repeated Absences	She Wore A Yellow Ribbon
Who lived longer, Edward Dearle or Michael Doeberl?	[Final Answer]: Edward Dearle	Edward Dearle
Where does Karin Stoltenberg's husband work at?	[Final Answer]: Norwegian Foreign Affairs	United Nations
Where was the director of film Lettre Ouverte born?	[Final Answer]: Alexandria, Egypt	Paris
Who is William Ii, Count Of Flanders's paternal grandmother?	[Final Answer]: Margaret I of Flanders	Mathilde of Bourbon
What is the place of birth of Clara Novello's father?	[Final Answer]: Cosenza	London
Which film came out earlier, Emmy Of Stork'S Nest or Indira Vizha?	[Final Answer]: Emmy Of Stork'S Nest	Emmy Of Stork'S Nest
Which film came out first, Celine: Through The Eyes Of The World or Dilan 1991?	[Final Answer]: Celine: Through The Eyes Of The World	Celine: Through The Eyes Of The World
Who was born earlier, Silas Hardy or Lee Mantle?	[Final Answer]: Silas Hardy	Lee Mantle
Where was the place of burial of Albert Frederick, Duke Of Prussia's mother?	[Final Answer]: Gurievsk	Königsberg
Where was the place of death of Juan Carlos Gumucio's wife?	[Final Answer]: Homs.	Homs
Who is the father of the director of film Gramps Is In The Resistance?	[Final Answer]: Jean-Marie Poiré	Alain Poiré
What is the place of birth of the performer of song Heaven (Namie Amuro Song)?	[Final Answer]: Japan	Naha, Okinawa
What nationality is Philip Of Ibelin (1180–1227)'s mother?	[Final Answer]: French	Byzantine
Who was born later, Joseph J. Magliocco or Viktoriya Zeynep Güneş?	[Final Answer]: Joseph J. Magliocco	Viktoriya Zeynep Güneş
When is the lead guitarist of List Of The Dillinger Escape Plan Band Members's birthday?	[Final Answer]: August 8, 1975	August 8, 1975
Where does Huma Abedin's husband work at?	[Final Answer]: disgraced former congressman	Chuck Schumer
Are the movies About A Wife, A Dream And Another... and The Doolins Of Oklahoma, from the same country?	"[Final Answer]: Yes. Both movies, ""About A Wife, A Dream And Another..."" and ""The Doolins of Oklahoma,"" are from the United States."	no
Which film came out earlier, Out Of The Rain or Les Résultats Du Féminisme?	[Final Answer]: Les Résultats Du Féminisme	Les Résultats Du Féminisme
Where did Giacomo Feo's wife die?	[Final Answer]: Forlì.	Florence
What is the place of birth of the director of film Swedenhielms?	[Final Answer]: Helsingfors (now Helsinki)	Helsingfors
Which country Jan Baptist Van Rensselaer's father is from?	[Final Answer]: Netherlands	Dutch
Which film was released earlier, Sathyavan Savithri or Kids Of The Round Table?	[Final Answer]: Kids Of The Round Table	Kids Of The Round Table
Where did Gigi Causey's husband graduate from?	[Final Answer]: New York University	Tisch
What nationality is Geodeung Of Geumgwan Gaya's mother?	[Final Answer]: Korean	India
Which film was released earlier, Xenoa or Divorce Invitation?	[Final Answer]: Xenoa	Xenoa
What is the cause of death of Alex Matthiessen's father?	[Final Answer]: acute leukemia	leukemia
What is the place of birth of Remigius Of Rouen's father?	[Final Answer]: Charles Martel	Herstal
When did Lord Patrick Crichton-Stuart's father die?	[Final Answer]: six months before he was born	22 January 1794
Which film has the director who was born earlier, It'S A Joke, Son! or The Thirty Nine Steps (1978 Film)?	[Final Answer]: It'S A Joke, Son!	It'S A Joke, Son!
Are both directors of films The Slayer (Film) and Moscow Heat from the same country?	"[Final Answer]: Yes. David Morris and Jacqui Morris are the directors of ""Mr. Right"" and ""The Slayer (Film)"", and Joseph S. Cardone is the director of ""Moscow Heat"". Both David Morris and Jacqui Morris are from the United Kingdom."	yes
Which school was established first, Whitehorse Manor Junior School or Sabawoon Rehabilitation Centre?	[Final Answer]: Whitehorse Manor Junior School	Sabawoon Rehabilitation Centre
Are Little Sachigo Lake and Holden Lake located in the same country?	[Final Answer]: Yes	yes
Who is Henriette Of France (1727–1752)'s maternal grandfather?	[Final Answer]: King Louis XV of France.	Stanisław Leszczyński
Which film has the director born first, Leave It To Henry or The Last Night Of Scheherazade?	[Final Answer]: Takhir Sabirov	Leave It To Henry
What is the date of death of Gero Ii, Margrave Of The Saxon Ostmark's father?	[Final Answer]: 13 March 993	3 August 979
Are Tomskoye, Amur Oblast and Pleshkovo located in the same country?	[Final Answer]: Yes	yes
Which film came out earlier, I Am Breathing or Ulti Ganga?	[Final Answer]: Ulti Ganga	Ulti Ganga
Who was born later, Levon Julfalakyan or Charlotte Spurkeland?	[Final Answer]: Levon Julfalakyan.	Charlotte Spurkeland
Who is the father of the director of film Red 2 (Film)?	[Final Answer]: Jon Hoeber	Aldo Parisot
When was the company that published American Scientist founded?	[Final Answer]: 1886	1886
What is the place of birth of Jo Planckaert's father?	[Final Answer]: Deinze	Nevele
What is the place of birth of Gwilym Lloyd George's father?	[Final Answer]: Tir Iarll, Glamorgan	Manchester
What is the place of birth of James Douglas, 3Rd Earl Of Angus's father?	[Final Answer]: William Douglas, 2nd Earl of Angus was born at Tantallon Castle in East Lothian.	Tantallon Castle
What nationality is the director of film They Call It Love?	[Final Answer]: German.	American
What is the place of birth of Zhanna Nemtsova's father?	[Final Answer]: Russia	Sochi
Which film has the director born earlier, Santa Fe Uprising or Trainer And Temptress?	[Final Answer]: Trainer And Temptress	Trainer And Temptress
Which film has the director who was born earlier, Adam'S Rib or Thendral Veesum?	[Final Answer]: Adam's Rib	Adam'S Rib
Which country the composer of film Continental, A Film Without Guns is from?	[Final Answer]: Canada	French
Where was the director of film Age-Old Friends born?	[Final Answer]: Allan Kroeker	Winnipeg, Manitoba
Which one was established first, Noerr or Korn Ferry?	[Final Answer]: Noerr	Noerr
Where was the father of Eleonora Di Garzia Di Toledo born?	[Final Answer]: Florence	Villafranca del Bierzo
What is the award that the director of film The Last Night Of The Barbary Coast got?	[Final Answer]: Jean Hersholt Humanitarian Award	Jean Hersholt Humanitarian Award
Who is Prince Nicolas, Duke Of Ångermanland's mother?	[Final Answer]: Princess Madeleine	Princess Madeleine, Duchess of Hälsingland and Gästrikland
Who is the paternal grandmother of Princess Augusta Of Waldeck-Pyrmont?	[Final Answer]: Countess Palatine Christiane Henriette of Zweibrücken- Birkenfeld.	Princess Augusta of Schwarzburg-Sondershausen
Where does the director of film The Marquise Of O (Film) work at?	[Final Answer]: Éric Rohmer.	Cahiers du cinéma
Which film whose director is younger, Joe Palooka In Fighting Mad or Figaro-Ci, Figaro-Là?	[Final Answer]: Figaro-Ci, Figaro-Là	Figaro-Ci, Figaro-Là
Which film was released first, Ekam – Son Of Soil or Farber'S Nerve?	[Final Answer]: Ekam – Son Of Soil was released first, on 23 April 2010, while Farber’s Nerve was programmed alongside Who I Am And What I Want in the 2006 Manhattan Short Film Festival world tour, which spanned 137 screenings.	Farber'S Nerve
Which country Mohammed Al-Modiahki's wife is from?	[Final Answer]: China.	China
Do both films: Gammat Jammat and Ready (2011 Film) have the directors from the same country?	[Final Answer]: Yes. Anees Bazmee directed Ready (2011 Film) and Sachin Pilgaonkar directed Gammat Jammat. Both directors are from India.	yes
Who is Philip Of Sicily's father?	[Final Answer]: Charles I of Naples.	Charles I of Naples
Who was born later, Gideon Johnson Pillow or Holm Jølsen?	[Final Answer]: Holm Jølsen	Holm Jølsen
Which film has the director who died first, The Crime Doctor'S Courage or Vasantha Sena (1967 Film)?	[Final Answer]: The Crime Doctor'S Courage	The Crime Doctor'S Courage
Where did the director of film My Heidelberg, I Can Not Forget You die?	[Final Answer]: Argentina	Argentina
Which film was released earlier, Tiger Of The Seven Seas or My Wife'S Lodger?	[Final Answer]: Tiger Of The Seven Seas	My Wife'S Lodger
Do Alice Mary Dowd and Richard N. Palmer have the same nationality?	[Final Answer]: Yes. Both Alice Mary Dowd and Richard N. Palmer were born in Connecticut.	yes
Who is the father of the director of film Wonders Of The Sea 3D?	[Final Answer]: Jean-Michel Cousteau	Jacques Cousteau
Which film has the director died first, Le Guignolo or Knights Of The Range?	[Final Answer]: Le Guignolo	Knights Of The Range
Who died later, Narcís Ventalló or H. Verlan Andersen?	[Final Answer]: Narcís Ventalló.	Narcís Ventalló
Which film was released first, The Beginning Or The End or Hold Back The Night?	[Final Answer]: The Beginning Or The End	The Beginning Or The End
Who is younger, Aneta Hladíková or René Poupardin?	[Final Answer]: Aneta Hladíková	Aneta Hladíková
Where was the place of death of Prince Christopher Of Greece And Denmark's father?	[Final Answer]: Thessaloniki	Thessaloniki
What is the place of birth of the director of film Guilty Of Treason?	[Final Answer]: New York City.	New York
Where did Charles Stewart, 3Rd Duke Of Richmond's father graduate from?	[Final Answer]: Paris.	University of Paris
What is the place of birth of the performer of song I Wish (Gabrielle Song)?	[Final Answer]: Hackney, London.	Hackney
When was the director of film Jinpa born?	[Final Answer]: December 1969	1969
Which film whose director is younger, Kalippava or A Couch In New York?	[Final Answer]: Kalippava	A Couch In New York
Which film has the director who died earlier, The Love Charm or The Constant Woman?	[Final Answer]: The Love Charm.	The Constant Woman
Which film came out earlier, Dis-Moi Qui Tuer or Under The Hawthorn Tree (Film)?	[Final Answer]: Dis-Moi Qui Tuer	Dis-Moi Qui Tuer
Where was the place of death of Tamatoa Vi's father?	[Final Answer]: Huahine	Huahine
Where did the director of film Old Man Drinking A Glass Of Beer die?	[Final Answer]: February 10, 2007.	Brighton
What is the date of death of Henry St John, 18Th Baron St John Of Bletso's father?	[Final Answer]: 17 October 1920	10 May 1912
Who is younger, Justin Paul or Helly Shah?	[Final Answer]: Justin Paul	Helly Shah
Who was born first out of Marco De Luigi and Fabio Maistro?	[Final Answer]: Fabio Maistro	Marco De Luigi
Which film has the director who died earlier, Guns And Guitars or To The Victor?	[Final Answer]: Guns And Guitars.	Guns And Guitars
Which film has the director who died later, His Last Haul or The Falcon In San Francisco?	[Final Answer]: His Last Haul	The Falcon In San Francisco
Who is Edward De Vere, 17Th Earl Of Oxford's paternal grandfather?	[Final Answer]: Hugh de Vere	John de Vere, 15th Earl of Oxford
Where was the place of death of Alexander Carl Otto Westphal's father?	[Final Answer]: Bonn	Kreuzlingen
Which film has the director born earlier, Jayam Manade or Bulldog Drummond'S Revenge?	[Final Answer]: Jayam Manade. Tatineni Prakash Rao was born on November 24, 1924, while Louis King, director of Bulldog Drummond's Revenge, was born on June 28, 1898.	Bulldog Drummond'S Revenge
Which film has the director who is older, The Gamecock (Film) or Monster A Go-Go?	[Final Answer]: The Gamecock (Film)	Monster A Go-Go
Where was the place of death of Alessandro Vitelli's father?	[Final Answer]: Citerna	Florence
Where was the performer of song Bag Skyerne born?	[Final Answer]: Århus	Århus
Are both directors of films 16 To Life and Saved By The Belles from the same country?	"[Final Answer]: Yes, both directors of ""16 to Life"" (Becky Smith) and ""Saved by the Belles"" (Ziad Touma) are from Canada."	yes
Where was the mother of Francis Ii Of France born?	[Final Answer]: Florence	Florence
Who was born later, Marc De Clerck or Wiesław Perszke?	[Final Answer]: Marc De Clerck.	Wiesław Perszke
Which film has the director born later, Jesse James' Women or Ride Lonesome?	[Final Answer]: Jesse James’ Women	Ride Lonesome
What nationality is the director of film Madeleine (1950 Film)?	[Final Answer]: English.	British
Which film has the director died first, Edge Of Doom or A Mother'S Secret?	[Final Answer]: Edge Of Doom	A Mother'S Secret
Which song was released earlier, 1990-Sick (Get 'Em All) or Who'S Laughing Now (Song)?	[Final Answer]: 1990-Sick (Get 'Em All)	1990-Sick (Get 'Em All)
Where did the director of film Desolation Angels (1995 Film) graduate from?	[Final Answer]: State University of New York at Purchase	State University of New York at Purchase
When did Richard Annesley, 2Nd Earl Annesley's father die?	[Final Answer]: 2 September 1770	2 September 1770
Which film has the director died earlier, Lemonade Joe or Bountiful Summer?	[Final Answer]: Lemonade Joe	Bountiful Summer
What is the date of death of Conan Ii, Duke Of Brittany's mother?	[Final Answer]: 1256	1080
When was the director of film Reykjavík-Rotterdam born?	[Final Answer]: 1963	30 June 1963
What is the place of birth of Eiludd Powys's father?	[Final Answer]: Dogfeiling	Wales
Where was the director of film At The End Of The Tunnel born?	[Final Answer]: Rosario.	Rosario
When was Ferdinand Iii Of Limburg Stirum's father born?	[Final Answer]: 1753	1701
Which country the director of film Ulzhan is from?	[Final Answer]: Kazakhstan	German
Who is Prince Franz De Paula Of Liechtenstein's paternal grandfather?	[Final Answer]: Prince Franz de Paula of Liechtenstein's paternal grandfather is Prince Franz Joseph I, Prince of Liechtenstein.	Franz Joseph I
What is the place of birth of Samir Rifai's father?	[Final Answer]: Amman	Amman
Who is the paternal grandmother of Archduchess Dolores Of Austria?	[Final Answer]: Archduchess Maria Theresa of Austria.	Princess Maria Immaculata of Bourbon-Two Sicilies
Which film has the director died first, Two For Tonight or Light Over Russia?	[Final Answer]: Two For Tonight	Two For Tonight
What is the place of birth of the director of film Peter'S Friends?	[Final Answer]: Kenneth Branagh	Belfast
Where was the composer of film Love Story 1999 born?	[Final Answer]: India.	Tamil
Who is the father of Beltrán Vélez De Guevara, Marquis Of Campo Real?	[Final Answer]: Iñigo Vélez de Guevara	Íñigo Vélez de Guevara, 7th Count of Oñate
Which film whose director is younger, Jeedar or The Rebel Set?	[Final Answer]: Jeedar	Jeedar
Where was the mother of Antonio Flores born?	[Final Answer]: Jerez de la Frontera	Jerez de la Frontera
What is the place of birth of the performer of song Down Ass Bitch?	[Final Answer]: Queens, New York.	Queens
What is the place of birth of Empress Xu (Ming Dynasty)'s husband?	[Final Answer]: China	Nanjing
Which film came out earlier, Niyoti or Angali Pangali?	[Final Answer]: Angali Pangali	Niyoti
Which country Aleksandra Marianna Wiesiołowska's father is from?	[Final Answer]: Poland	Polish–Lithuanian Commonwealth
Which country Tivala's father is from?	[Final Answer]: Sri Lanka	Maurya dynasty
Who is the paternal grandmother of King Kang Of Zhou?	[Final Answer]: Queen Yi Jiang (邑姜)	Yi Jiang
Which film has the director who died first, The Face Of Fu Manchu or The Hidden One?	[Final Answer]: The Face Of Fu Manchu	The Hidden One
What is the place of birth of the director of film Double Or Nothing (1940 Film)?	[Final Answer]: New Brunswick, New Jersey	New Brunswick, New Jersey
Which film whose director was born first, The Great Flamarion or The Hollars?	[Final Answer]: The Great Flamarion	The Great Flamarion
Do both directors of films Dangerous To Know and Les Côtelettes have the same nationality?	[Final Answer]: Yes. Robert Florey directed both Dangerous to Know and Les Côtelettes. Bertrand Blier directed Les Côtelettes. Therefore, they share the nationality of French.	yes
Are both villages, Mavrolithari and Ampelakia, Evros, located in the same country?	[Final Answer]: Yes	yes
Where was the place of death of the director of film Kathputli (1971 Film)?	[Final Answer]: Mumbai	Bombay
Where did the director of film Ręce Do Góry study?	[Final Answer]: Jerzy Skolimowski	National Film School in Łódź
Where was the place of death of Suzanne Farrington's mother?	[Final Answer]: Beaulieu- sur- Loire	London
What nationality is the director of film Name The Man?	[Final Answer]: Swedish	Swedish
Do Kreesha Turner and Samantha Jo share the same nationality?	[Final Answer]: Yes. Kreesha Turner is Canadian/Jamaican and Samantha Jo is Canadian.	yes
What is the place of birth of the director of film Aurora (2018 Film)?	[Final Answer]: Yam Laranas	Davao
Which film has the director born later, Befikre or American Sniper?	[Final Answer]: Befikre	Befikre
When is Prince Napoléon Bonaparte's father's birthday?	[Final Answer]: September 9, 1822.	15 November 1784
Which film was released more recently, Toolbox Murders or I Met You In Naples?	[Final Answer]: Toolbox Murders.	Toolbox Murders
Where was the place of death of the composer of song How Long Has This Been Going On??	[Final Answer]: 1927	Hollywood
Which film has the director died earlier, Youngblood Hawke (Film) or Crook'S Tour?	[Final Answer]: Youngblood Hawke.	Crook'S Tour
Where did William S. Burroughs Jr.'s father study?	[Final Answer]: English, anthropology, and medical school in Vienna.	Harvard
Which film has the director who was born earlier, Circus Beely or Tom, Dick And Harry 2?	[Final Answer]: Circus Beely	Circus Beely
Who is the maternal grandmother of Felipe De Marichalar Y Borbón?	[Final Answer]: Infanta Elena	Queen Sofía of Spain
Are the directors of both films The Fall Of A Saint and Fighting Through from the same country?	[Final Answer]: Yes. W.P. Kelino was a British circus clown, acrobat, and film director, and Christy Cabanne was an American film director, screenwriter, and silent film actor.	no
Which country Natalie Portman's husband is from?	[Final Answer]: England	French
Who is the father-in-law of Tsandzile Ndwandwe?	[Final Answer]: Sobhuza I	Ndvungunye
Which film has the director born earlier, Mister Scarface or Waking Sleeping Beauty?	[Final Answer]: Mister Scarface	Mister Scarface
What is the place of birth of the performer of song Hunter (Björk Song)?	[Final Answer]: Reykjavík	Reykjavík
Who is the paternal grandfather of Richard Beauchamp, 1St Earl Of Worcester?	[Final Answer]: Thomas de Beauchamp, 11th Earl of Warwick	Thomas de Beauchamp
Who is the spouse of the director of film Carol'S Journey?	[Final Answer]: Imanol Uribe	María Barranco
Which film has the director born later, Diary Of A Maniac or Return Of The Hero?	[Final Answer]: Return Of The Hero	Return Of The Hero
Where was the father of Augustus William, Duke Of Brunswick-Bevern born?	[Final Answer]: Osterholz	Osterholz
Who is the mother-in-law of Lollia Paulina?	[Final Answer]: Cornelia	Agrippina the Elder
Which film was released more recently, Gaza Ghetto or Kull The Conqueror?	[Final Answer]: Gaza Ghetto	Kull The Conqueror
Who was born earlier, Raúl Osorio or James B. Harris?	[Final Answer]: Raúl Osorio	James B. Harris
When was the company that published Woman'S Century founded?	[Final Answer]: 1893	October 27, 1893
Who is Charles Willoughby, 10Th Baron Willoughby Of Parham's paternal grandmother?	[Final Answer]: Frances Manners	Lady Frances Manners
Which film has the director who died earlier, Deuce High or The King Is The Best Mayor?	[Final Answer]: Deuce High.	The King Is The Best Mayor
Which film was released earlier, Premium (Film) or Week-End With Father?	[Final Answer]: Week-End With Father	Week-End With Father
What nationality is Gevherhan Sultan (Daughter Of Selim Ii)'s father?	[Final Answer]: Ottoman Turkish.	Ottoman Empire
Are both Țerova and Slava (River) located in the same country?	[Final Answer]: No. Țerova is located in Romania, while Slava is located in Romania.	yes
Are Graduate University Of Advanced Technology and Fruita Schoolhouse located in the same country?	[Final Answer]: Yes.	no
Who is the paternal grandmother of Prince William Of Hesse-Kassel?	[Final Answer]: Hedwig Sophia of Brandenburg	Princess Mary of Great Britain
Where did the presenter of Tim Russert (Talk Show) die?	[Final Answer]: June 2008.	Washington
Which film has the director who died earlier, 11 Harrowhouse or A Little Sister Of Everybody?	[Final Answer]: 11 Harrowhouse	A Little Sister Of Everybody
What is the place of birth of the director of film The Last Horror Movie?	[Final Answer]: Newport, South Wales, Monmouthshire	Newport
Which film has the director who is older, The Woman In The Fifth or End Of Winter?	[Final Answer]: The Woman In The Fifth	The Woman In The Fifth
Which film has the director who is older, The Girl King or Happy As The Grass Was Green?	[Final Answer]: The Girl King	Happy As The Grass Was Green
Who is George Fitzroy, 1St Duke Of Northumberland's stepmother?	[Final Answer]: Catherine Wheatley	Catherine of Braganza
Where does the director of film Ghost In The Machine (Film) work at?	[Final Answer]: Rachel Talalay.	University of British Columbia
Are Elsah, Illinois and Chah-E Puzeh, Tabas both located in the same country?	[Final Answer]: Yes	no
Who is the paternal grandmother of Louis, Count Of Verdun?	[Final Answer]: Hubba bint Hulail	Gerberge of Lorraine
What nationality is Anne Of Burgundy's father?	[Final Answer]: French	France
Which film has the director who was born later, All The Gold In The World or The Crowning Touch?	[Final Answer]: All The Gold In The World	The Crowning Touch
Who lived longer, Csaba Pálinkás or Henry Scheffé?	[Final Answer]: Henry Scheffé	Henry Scheffé
Which film was released more recently, Pirates Of The Prairie or Alien Origin?	[Final Answer]: Alien Origin	Alien Origin
Who is the mother of Edward I Of England?	[Final Answer]: Eleanor of Castile	Eleanor of Provence
What is the date of death of Joan, Countess Of Blois's mother?	[Final Answer]: 1291	2 August 1288
Which album came out first, Issa Album or 3.2.1.?	[Final Answer]: Issa Album.	3.2.1.
Who is Sancho Ramírez's maternal grandfather?	[Final Answer]: Bernard II, Count of Bigorre	Bernard-Roger, Count of Bigorre
Which film was released earlier, New Jersey Drive or It Happened At The World'S Fair?	[Final Answer]: New Jersey Drive	It Happened At The World'S Fair
Who is the spouse of the performer of song Lolita (Leah Labelle Song)?	[Final Answer]: Rasual Butler	Rasual Butler
Do director of film Winter Meeting and director of film Year Of The Horse have the same nationality?	[Final Answer]: No.	no
Where does Chris Warren (Rugby League)'s father work at?	[Final Answer]: Ray Warren is a member of the panel on Triple M Sydney's radio Saturday morning sports program Dead Set Legends.	Nine Network
Where did Davey Boy Smith Jr.'s mother study?	[Final Answer]: Hot Springs, Arkansas	Stampede Wrestling
Which country Thomas Lyon-Bowes, Lord Glamis's father is from?	[Final Answer]: England	British
What nationality is the performer of song Adore You (Jessie Ware Song)?	[Final Answer]: English.	United Kingdom
Which film whose director is younger, Dallas 362 or Revenge Of The Barbarians?	[Final Answer]: Dallas 362.	Dallas 362
Which film has the director born earlier, Spring Storms or Fun In The Barracks?	[Final Answer]: Spring Storms	Fun In The Barracks
Where was the father of Andrew Balding born?	[Final Answer]: US	US
Which film was released earlier, Anna-Liisa or Children Underground?	[Final Answer]: Anna-Liisa	Anna-Liisa
Are Arnold Palmer Regional Airport and Luis Muñoz Marín International Airport located in the same country?	[Final Answer]: Yes.	yes
Which award the composer of film Pataakha won?	[Final Answer]: Best Film Critics	National Film Award for Best Music Direction
What is the place of birth of the performer of song Damage (Pharoahe Monch Song)?	[Final Answer]: South Jamaica, Queens, New York.	Queens
Where did Henry C. Lord's father graduate from?	[Final Answer]: Dartmouth College	Bowdoin College
Which film whose director is younger, Uncharted Seas or Something Of Value?	[Final Answer]: Uncharted Seas	Something Of Value
Which film has the director born later, My Own Private Idaho or Lucignolo?	[Final Answer]: My Own Private Idaho	Lucignolo
What is the date of birth of Prince Bernhard Of Orange-Nassau, Van Vollenhoven's father?	[Final Answer]: 26 August 1872	April 30, 1939
Are the bands The Catheters and Dark At Dawn, from the same country?	[Final Answer]: Yes. The Catheters are from Germany, while Dark at Dawn is from New Zealand.	no
Who is the paternal grandmother of Ingegerd Olofsdotter Of Sweden?	[Final Answer]: Estrid of the Obotrites	Sigrid the Haughty
Where was the place of death of the creator of Conan The Adventurer (1992 Tv Series)?	[Final Answer]: his car	Cross Plains
Are the directors of films The Swordsman (Upcoming Film) and Shopworn both from the same country?	[Final Answer]: No. One director, Joseph H. Lewis, is American, while the other, Nick Grindé, is American.	no
Are The Man Who Knew Too Much (1956 Film) and Man On Wire both from the same country?	"[Final Answer]: No. The 1956 film ""The Man Who Knew Too Much"" is an American film, while ""Man on Wire"" is a British-American documentary film."	yes
What is the place of birth of the director of film The Fj Holden?	[Final Answer]: Sydney, Australia	Sydney, Australia
Who was born later, Lisbeth Cathrine Amalie Rose or Princess Raiyah Bint Hussein?	[Final Answer]: Lisbeth Cathrine Amalie Rose.	Princess Raiyah Bint Hussein
Where was the performer of song Step Into The Light (Myra Song) born?	[Final Answer]: Los Angeles, California.	California
Which country the director of film One Night At Mccool'S is from?	[Final Answer]: United States.	Norwegian
Who is the paternal grandfather of Beatrice I, Abbess Of Quedlinburg?	[Final Answer]: Henry III	Conrad II
Who is the paternal grandmother of John Iii, Duke Of Cleves?	[Final Answer]: Mary of Burgundy	Elizabeth of Nevers
Where was the place of death of George Thomas Orlando Bridgeman's father?	[Final Answer]: The Hall, Wigan	Weston Park
What nationality is Imperial Noble Consort Chunhui's husband?	[Final Answer]: Han Chinese	Qing dynasty
Which film has the director who died later, Say It With Flowers or Boot Hill Bandits?	[Final Answer]: Say It With Flowers	Boot Hill Bandits
Who is younger, Nicolas Görtler or Michel De Salzmann?	[Final Answer]: Nicolas Görtler	Nicolas Görtler
Which country Anthemiolus's father is from?	[Final Answer]: Western Roman Empire.	Roman Empire
Where was the place of burial of the performer of song This Time (Waylon Jennings Song)?	[Final Answer]: The information does not state where Waylon Jennings was buried.	Arizona
Who is Charles D'Orléans, Duke Of Penthièvre's paternal grandfather?	[Final Answer]: Louis XIV of France.	Louis Philippe II, Duke of Orléans
Which film has the director who is older than the other, Judy Berlin or Tonight At Twelve? 	[Final Answer]: Judy Berlin	Tonight At Twelve
What nationality is Ferdinand Of Portugal, Duke Of Guarda's mother?	[Final Answer]: Spanish.	Spanish
Did the movies Passer L'Hiver and In My Skin, originate from the same country?	[Final Answer]: Yes	yes
Are both director of film Germany, Year Zero and director of film Cross Shot from the same country?	[Final Answer]: No. Roberto Rossellini directed Germany, Year Zero, and Stelvio Massi directed Cross Shot. Rossellini is Italian and Massi is Italian.	yes
Which film has the director who was born first, Ghost-Town Gold or The Musician Killer?	[Final Answer]: Ghost-Town Gold	Ghost-Town Gold
What is the place of birth of Consort Liang's husband?	[Final Answer]: Shenyang	Chinese
Where did Muza Niyazova's husband die?	[Final Answer]: Ashgabat.	Ashgabat
Are both stations, Muzaffargarh Railway Station and Raisan Railway Station, located in the same country?	[Final Answer]: Yes	yes
Do John Amyas Alexander and Albert Seward share the same nationality?	[Final Answer]: Yes, John Amyas Alexander and Albert Seward share the same nationality, which is British.	yes
Who is younger, Bernard Chambaz or Tibor Pézsa?	[Final Answer]: Bernard Chambaz	Bernard Chambaz
Which award the composer of film Bhookh (1947 Film) won?	[Final Answer]: Sangeet Natak Akademi Award	Sangeet Natak Akademi Award
Which film has the director who was born first, The Ballad Of Gregorio Cortez or Naiyya?	[Final Answer]: The Ballad of Gregorio Cortez	The Ballad Of Gregorio Cortez
Which film has the director who is older, The Boy Turns Man or A Strange Adventure?	[Final Answer]: The Boy Turns Man	A Strange Adventure
Who is Joan, Countess Of Chiny's paternal grandfather?	[Final Answer]: Otto I, Count of Chiny.	Louis III, Count of Chiny
Where was the father of Prince Charles Louis, Duke Of Chartres born?	[Final Answer]: Madrid.	Rabat
Where was the place of burial of Ælfgar, Earl Of Mercia's mother?	[Final Answer]: Mount Washington Cemetery, Independence Missouri.	Coventry
Which country Dexter Young's mother is from?	[Final Answer]: Hong Kong	China
Who is the spouse of the performer of song Ängeln I Rummet?	[Final Answer]: Sergio Grieco	Efva Attling
Where was the performer of song Égérie (Song) born?	[Final Answer]: French-Greek.	La Trinité
Who is Thomas Stafford, 3Rd Earl Of Stafford's father?	[Final Answer]: Thomas de Beauchamp, 11th Earl of Warwick	Hugh de Stafford, 2nd Earl of Stafford
What is the place of birth of the director of film Stopp! Tänk På Något Annat?	[Final Answer]: Västerås	Västerås
Who is the child of the director of film Lo Que Le Pasó A Reynoso?	[Final Answer]: Leopoldo Torres Ríos	Leopoldo Torre Nilsson
Which film was released more recently, Circus Of Love or The Kiss Of Evil?	[Final Answer]: The Kiss of Evil.	The Kiss Of Evil
Which film has the director who is older than the other, One Down, Two To Go or Andrei Svislotskiy? 	[Final Answer]: Andrei Svislotskiy	One Down, Two To Go
Who is the maternal grandfather of Adam Coleman Howard?	"[Final Answer]: Henry J."" Red"" Krause, Jr."	Jules Lederer
Which film has the director born later, Under The Lantern or Darling Of The Gods?	[Final Answer]: Under The Lantern	Under The Lantern
Which film has the director who was born first, Slim Carter or Thendral Veesum?	[Final Answer]: Slim Carter	Thendral Veesum
Which film has the director who died first, A Dream Or Two Ago or Why Leave Home??	[Final Answer]: A Dream Or Two Ago	A Dream Or Two Ago
Where did the director of film Vestire Gli Ignudi die?	[Final Answer]: Paris.	Paris
Which film has the director died earlier, John Jaffer Janardhanan or Kamakalawa?	[Final Answer]: John Jaffer Janardhanan	Kamakalawa
Which film has the director died earlier, The Story Of Anastasia or A Mother Of Men?	[Final Answer]: The Story Of Anastasia	A Mother Of Men
Which film was released more recently, Occupation: Dreamland or Ganga Bhavani?	[Final Answer]: Occupation: Dreamland.	Occupation: Dreamland
Who is Frederick Of Luxembourg's paternal grandfather?	[Final Answer]: Count Palatine Wigeric of Lotharingia	Wigeric of Lotharingia
Who is the father of the director of film Mirage (1972 Film)?	[Final Answer]: Armando Robles Godoy	Daniel Alomía Robles
Where did Claudio Silva (Computer Scientist)'s wife graduate from?	[Final Answer]: Stony Brook University.	Stony Brook University
Which film has the director born first, Spione or Five Million Look For An Heir?	[Final Answer]: Fritz Lang	Five Million Look For An Heir
Which film was released earlier, Man'S Search For Happiness or Tell It To The Bees?	[Final Answer]: Man'S Search For Happiness	Man'S Search For Happiness
Which film has the director born first, La Mazurka Del Barone, Della Santa E Del Fico Fiorone or Safe (2012 Film)?	[Final Answer]: La Mazurka Del Barone, Della Santa E Del Fico Fiorone	La Mazurka Del Barone, Della Santa E Del Fico Fiorone
Who lived longer, Antonio Caggiano or Hardyal Singh?	[Final Answer]: Hardyal Singh. Hardyal Singh lived until 2018, while Antonio Caggiano died in 1979.	Antonio Caggiano
What is the place of birth of the director of film A Woman'S Face (1938 Film)?	[Final Answer]: Helsingfors (now Helsinki)	Helsingfors
Where did the composer of film The Merry Monahans die?	[Final Answer]: Studio City, Cal.	Studio City
Which school was opened first, Chopasni Senior Secondary School, Jodhpur or Tunku Putra School?	[Final Answer]: Chopasni Senior Secondary School, Jodhpur.	Chopasni Senior Secondary School, Jodhpur
Who is Richard Burke, 4Th Earl Of Clanricarde's paternal grandfather?	[Final Answer]: Ulick MacRichard Burke, 1st Marquess of Clanricarde, 5th Earl of Clanricarde, 2nd Earl of St Albans.	Richard Burke, 2nd Earl of Clanricarde
Which film has the director who was born earlier, Retalhos Da Vida De Um Médico or The Shooting?	[Final Answer]: Retalhos Da Vida De Um Médico	Retalhos Da Vida De Um Médico
Are Blurt (Magazine) and Maui Nō Ka ʻOi Magazine from the same country?	[Final Answer]: Yes. Blurt (Magazine) and Maui Nō Ka ʻOi Magazine are both based in Hawaii (Maui specifically).	yes
Who is the paternal grandfather of John Ii Of Baden?	[Final Answer]: Bernard I, Margrave of Baden-Baden	Bernard I, Margrave of Baden-Baden
Which film came out first, Ami Neta Hobo or Hood Of The Living Dead?	[Final Answer]: Ami Neta Hobo	Hood Of The Living Dead
Which film has the director who was born earlier, Buffet Froid or Lost In Africa?	[Final Answer]: Buffet froid.	Buffet Froid
Who is the spouse of the director of film My Three Merry Widows?	[Final Answer]: Mapy Cortés	Mapy Cortés
Where did Meritaten's father die?	[Final Answer]: Akhenaten	Akhetaten
Who is the paternal grandmother of Edward I Of England?	[Final Answer]: Isabella of Angoulême	Isabella of Angoulême
Who is the paternal grandfather of Guy Le Strange?	[Final Answer]: Henry L'Estrange Styleman Le Strange	Henry Styleman
Who is Germaine Of Foix's paternal grandfather?	[Final Answer]: Charles, Duke of Orléans.	Gaston IV of Foix
Which film has the director who died earlier, Gold For The Caesars or Heinz In The Moon?	[Final Answer]: Gold for the Caesars	Heinz In The Moon
Which film has the director born later, Monsieur Taxi or A Yiddish World Remembered?	[Final Answer]: Monsieur Taxi	A Yiddish World Remembered
What is the date of death of the director of film Escándalo De Estrellas?	[Final Answer]: August 7, 2004	August 7, 2004
Which film has the director born first, Trouble With Jolanthe or Children Of Fortune?	[Final Answer]: Trouble With Jolanthe	Trouble With Jolanthe
Where was the composer of film Terror In The Aisles born?	"[Final Answer]: The information does not state where the composer of ""Terror in the Aisles"" was born."	California
Which film whose director is younger, Roland The Mighty or Graves Without A Name?	[Final Answer]: Roland The Mighty.	Graves Without A Name
What is the cause of death of performer of song Oh Boy, Oh Boy, Oh Boy!?	[Final Answer]: laryngeal cancer	laryngeal cancer
Which film has the director who is older, When You'Re Strange or Vzdušné Torpédo 48?	[Final Answer]: Vzdušné Torpédo 48	Vzdušné Torpédo 48
What nationality is Beatrice I, Countess Of Burgundy's husband?	[Final Answer]: French	Germany
Which film was released first, Taxi Zum Klo or Saajan Bina Suhagan?	[Final Answer]: Taxi Zum Klo	Saajan Bina Suhagan
Which film has the director born first, Şaban, Son Of Şaban or East/West?	[Final Answer]: Şaban, Son Of Şaban	Şaban, Son Of Şaban
Where did George Lane-Fox (Mp)'s father study?	[Final Answer]: Marylebone School, Christ's College, Cambridge	Christ's College, Cambridge
Which film has the director born first, Stella'S Oorlog or Don Juan In A Girls' School?	[Final Answer]: Don Juan In A Girls' School	Don Juan In A Girls' School
Where was the place of death of Christiane Vulpius's husband?	[Final Answer]: Entrevaux	Weimar
Which film has the director died earlier, Dialogues Of Exiles or Rhythm And Weep?	[Final Answer]: Dialogues Of Exiles	Rhythm And Weep
Which film came out first, My Wife'S Lodger or Ko 2?	[Final Answer]: My Wife’S Lodger	My Wife'S Lodger
Which film has the director born later, Allos Gia To Ekatommyrio or Elvira'S Haunted Hills?	[Final Answer]: Allos Gia To Ekatommyrio	Elvira'S Haunted Hills
Who is the uncle of Catherine Allégret?	[Final Answer]: Yves Montand	Marc Allégret
Who is the paternal grandfather of George De Salis?	[Final Answer]: Leopold William Jerome Fane De Salis	Jerome, 4th Count de Salis-Soglio
What is the date of death of Catherine Of Guelders's father?	[Final Answer]: 1473	23 February 1473
Who is the father of the composer of song I Miss You (Miley Cyrus Song)?	[Final Answer]: Brian Green	Billy Ray Cyrus
What is the place of birth of the director of film Operation Secret?	[Final Answer]: New York, New York	New York
Who was born first out of Alexey Volkonsky and Wanderley Oliveira?	[Final Answer]: Alexey Volkonsky.	Wanderley Oliveira
Where did Bianca Riario's father die?	[Final Answer]: Girolamo Riario	Forlì
Where was the director of film Bollywood Calling born?	[Final Answer]: Perizaad Zorabian	Hyderabad
Are Doboy Railway Station and Adamstown Railway Station, New South Wales located in the same country?	[Final Answer]: Yes	yes
Which film has the director born earlier, Idols Of The Radio or Solos En La Madrugada?	[Final Answer]: Idols Of The Radio	Idols Of The Radio
Who is the mother of the performer of song Feel Good (Robin Thicke Song)?	[Final Answer]: Paula Patton	Gloria Loring
Where did Tamara Imeretinsky's father graduate from?	[Final Answer]: Lancing College	Lancing College
Who died first, Louis-René De Caradeuc De La Chalotais or Hermann Friedrich Graebe?	[Final Answer]: Louis-René De Caradeuc De La Chalotais	Louis-René De Caradeuc De La Chalotais
Where was the place of death of James Adam (Architect)'s father?	[Final Answer]: London	Edinburgh
Where did Edmund Tudor, 1St Earl Of Richmond's wife graduate from?	[Final Answer]: The information provided does not state where Edmund Tudor, 1st Earl of Richmond’s wife, Margaret Beaufort, graduated from.	St John's College
Which film was released more recently, Aami or Bitch Slap?	[Final Answer]: Aami	Aami
Who is Busba Kitiyakara's paternal grandfather?	[Final Answer]: Mom Chao Nakkhatra Mangala Kitiyakara	Kitiyakara Voralaksana
Who is the father of the director of film Ae Dil Hai Mushkil?	[Final Answer]: Yash Johar	Yash Johar
Who was born first out of Ramsay Anderson and Fernand Fédronic?	[Final Answer]: Ramsay Anderson	Ramsay Anderson
Are the directors of films Scuola Di Ladri and Pensione Paura both from the same country?	[Final Answer]: Yes. Neri Parenti directed both *Scuola di ladri* and *Pensione Paura*, and both were produced in Italy.	yes
What is the place of birth of the director of film Dawn Of Life?	[Final Answer]: San Juan, Puerto Rico	San Juan, Puerto Rico
Where was the husband of Jeanne Raunay born?	[Final Answer]: André Beaunier was born in Évreux.	Évreux
Are the directors of films The Edifying And Joyous Story Of Colinot and Cold Moon both from the same country?	[Final Answer]: Yes	yes
What is the place of birth of the performer of song Pluto (Song)?	[Final Answer]: Kingston.	Reykjavík
What is the place of birth of Princess Margaretha Of Saxony's mother?	[Final Answer]: Dresden	Munich
Who is the spouse of the director of film West Of Shanghai?	[Final Answer]: Maureen O’Sullivan	Maureen O'Sullivan
Do director of film Jerry And Tom and director of film Kansas City Princess share the same nationality?	[Final Answer]: No.	no
Which film was released earlier, Amelie Or The Time To Love or Beginners?	[Final Answer]: Amelie	Amelie Or The Time To Love
What is the cause of death of composer of song Look At Me (Xxxtentacion Song)?	[Final Answer]: XXXTentacion was fatally shot at a motorcycle dealership in Deerfield Beach, Florida.	shot
Which film came out first, Natürlich Die Nelli or Cairo Declaration (Film)?	[Final Answer]: Natürlich die Nelli	Natürlich Die Nelli
Who is Constantine Palaiologos (Son Of Andronikos Ii)'s maternal grandmother?	[Final Answer]: Anna of Hungary	Elizabeth the Cuman
Where was the performer of song Lucky Me, Lucky You born?	[Final Answer]: Lee Roy Parnell was born in December 21, 1956 in Nanterre, Hauts-de-Seine, France.	Abilene
What is the place of birth of the creator of Miss Seventeen?	[Final Answer]: Tehran.	Tehran
Who is the mother of the director of film Brenda Brave?	[Final Answer]: Astrid Lindgren	Käbi Laretei
Where was the place of burial of Meritites I's husband?	[Final Answer]: Mount Washington Cemetery, Independence Missouri.	Great Pyramid of Giza
Who is Wisigard's father-in-law?	[Final Answer]: Theudebert I	Theuderic I
Where was the place of death of Duchess Maria Dorothea Of Württemberg's father?	[Final Answer]: Carlsruhe (now Pokój).	Kirchheim unter Teck
Where was the director of film The Pride Of Jennico (Film) born?	[Final Answer]: Del Norte, Colorado	Colorado
Where was the director of film Gently My Songs Entreat born?	[Final Answer]: Austria	Viennese
What is the cause of death of Eleanor De Clare's husband?	[Final Answer]: hanged, drawn and quartered.	hanged, drawn and quartered
What is the cause of death of performer of song Voi Voi?	"[Final Answer]: The performer of ""Voi Voi"", Nora Brockstedt, died after a short illness at Ullevaal Hospital in Oslo on 5 November 2015."	illness
Which film has the director died first, Resan Till Dej or Rocking Moon?	[Final Answer]: Resan Till Dej	Rocking Moon
Which film has the director born later, Christ Walking On The Water or 45 Fathers?	[Final Answer]: Christ Walking on the Water	45 Fathers
Are both directors of films Breslin And Hamill: Deadline Artists and Jean The Tenant from the same country?	"[Final Answer]: Yes, both directors of films ""Breslin and Hamill: Deadline Artists"" (Jonathan H. Alter and John Block, Jonathan H. Alter) and ""Jean the Tenant"" (Michael Curtiz) are from the same country, Hungary."	yes
Are Bal Vidyalaya (Kota) and Loreto House both located in the same country?	[Final Answer]: Yes	yes
When did Engelbert, Count Of Nevers's mother die?	[Final Answer]: 1483	21 June 1483
Which film has the director died later, Excursion Train or Bad Day At Black Rock?	[Final Answer]: Excursion Train	Bad Day At Black Rock
Which film has the director who died later, Emanuelle And The Last Cannibals or Hostile Country?	[Final Answer]: Emanuelle And The Last Cannibals	Emanuelle And The Last Cannibals
Which film has the director died later, Just Like A Woman (1939 Film) or Madigan'S Millions?	[Final Answer]: Madigan's Millions	Madigan'S Millions
Why did the performer of song Ludlow Massacre (Song) die?	[Final Answer]: Woody Guthrie died from complications of Huntington's disease.	Huntington's disease
Which film has the director who died later, Cooee And The Echo or Sweepings?	[Final Answer]: Cooee And The Echo	Sweepings
Which film has the director born earlier, The Newest Pledge or Más Allá De La Aventura?	[Final Answer]: The Newest Pledge	Más Allá De La Aventura
Where was the director of film Slingshot (Film) born?	[Final Answer]: Jay Alaimo	Suffield, Connecticut
Which film has the director who was born first, I Come With The Rain or A Question Of Attribution?	[Final Answer]: I Come With The Rain	A Question Of Attribution
Are Coal City, Illinois and Lash Kenar, Nur both located in the same country?	[Final Answer]: Yes	no
Who is the mother of Olaf (Ii) Haraldsen?	[Final Answer]: The text does not explicitly state the mother of Olaf (Ii) Haraldsen. It only identifies him as the son of Harald Kesja and thus nephew of King Eric II of Denmark.	Ragnild Magnusdotter
What nationality is Florent Of Hainaut's mother?	[Final Answer]: Dutch	Germany
Where was the director of film The Love Captive born?	[Final Answer]: Max Marcin	Poznań
Are the directors of both films Der Blindgänger and Hotel Desire from the same country?	[Final Answer]: Yes. Andreas Samland is a German film maker and Sergej Moya was born in Berlin, Germany.	yes
Who is the spouse of the director of film Noc Nevěsty?	[Final Answer]: Alena Mihulová.	Alena Mihulová
Which film has the director who died later, The Death Kiss or Her Luck In London?	[Final Answer]: The Death Kiss	Her Luck In London
Which film whose director is younger, The Devil'S Pass Key or La Bella Di Lodi?	[Final Answer]: La Bella Di Lodi	La Bella Di Lodi
Where did the composer of film Henry V (1944 Film) die?	[Final Answer]: Oldham, Lancashire	Ischia
Which film has the director who is older, Johnny Concho or One Minute To Twelve?	[Final Answer]: Johnny Concho	One Minute To Twelve
Which album came out earlier, Was I The Wave? or Kingdom Of Rock?	[Final Answer]: Was I The Wave?	Was I The Wave?
Which film has the director born later, Cyclone Of The Saddle or Blind Corner?	[Final Answer]: Cyclone Of The Saddle	Blind Corner
Where did the director of film The Gallant Lords Of Bois-Doré die?	[Final Answer]: Paris	Paris
Which film came out earlier, It'S Our Life! or Maximum Ride (Film)?	[Final Answer]: It'S Our Life!	It'S Our Life!
Where did the director of film The Boy Who Cried Werewolf (1973 Film) die?	[Final Answer]: Palos Verdes Estates, California, USA	Palos Verdes
Where was the director of film Los Motivos De Luz born?	[Final Answer]: Mexico, D.F.	France
Where was the performer of song Fast Car (Namie Amuro Song) born?	[Final Answer]: Tokyo	Naha, Okinawa
Who is Charles Gordon, 2Nd Earl Of Aboyne's paternal grandmother?	[Final Answer]: Elizabeth Lyon	Lady Anne Campbell
Where was the director of film En Aasai Rasave born?	[Final Answer]: Kasthuri Raja	Theni
Where was the director of film High (Film) born?	[Final Answer]: Montreal	Johannesburg, South Africa
Where was the place of death of Ginevra D'Este's husband?	[Final Answer]: Thebes	Rimini
What is the place of birth of the director of film Tři Chlapi V Chalupě?	[Final Answer]: Prostějov	Prostějov
Who died first, Olaf Everson or Abdul Wahab Khan Tarzi?	[Final Answer]: Olaf Everson	Abdul Wahab Khan Tarzi
Which film has the director who died later, Good Morning, Little Countess or Vogue La Galère?	[Final Answer]: Good Morning, Little Countess	Vogue La Galère
Who died later, Stephen De Staebler or Samuel Arthur Saunder?	[Final Answer]: Stephen De Staebler	Stephen De Staebler
Where was the husband of Esperanza Osmeña born?	[Final Answer]: The husband of Esperanza Osmeña, Sergio Osmeña Sr., was born in Quezon City, Philippines.	Cebu
Where was the place of death of the director of film Scugnizzi?	[Final Answer]: Fregene, near Rome	Rome
Which film has the director who was born later, The Daughter Of Rosie O'Grady or The Whistle (Film)?	[Final Answer]: The Daughter Of Rosie O'Grady	The Daughter Of Rosie O'Grady
Do both films Happiness Of Three Women and Percy (1925 Film) have the directors from the same country?	[Final Answer]: Yes. William Desmond Taylor directed Happiness of Three Women (1917) and Roy William Neill directed Percy (1925 Film). Both were born in different countries, Taylor in the United States and Neill in Ireland.	yes
Which film has the director who was born earlier, Invasion 1897 or Nene Raju Nene Mantri?	[Final Answer]: Invasion 1897	Nene Raju Nene Mantri
Who did Joan Ramon Ii, Count Of Cardona marry?	[Final Answer]: Joana de Prades, heiress of Prades and Entenza.	Joana de Prades
Who is the paternal grandmother of Sudeley Hanbury-Tracy, 3Rd Baron Sudeley?	[Final Answer]: Henrietta Susanna Tracy	Henrietta Susanna Tracy
Which album was released more recently, The Arockalypse or Because The Internet?	[Final Answer]: Because The Internet.	Because The Internet
Are the movies On A Clear Day You Can See Forever (Film) and Education Of A Prince, from the same country?	[Final Answer]: No. “On a Clear Day You Can See Forever” is an American film, while “Éducation de Prince” is a French film.	no
Which film whose director is younger, Torments Of The Night or Dirty Dancing?	[Final Answer]: Torments Of The Night	Dirty Dancing
Where did the director of film Music In Darkness die?	[Final Answer]: The information does not state where the director of film Music in Darkness died.	Fårö
Which country Aleksander Koniecpolski (1620–1659)'s father is from?	[Final Answer]: Poland	Polish-Lithuanian Commonwealth
Who is Archibald Acheson, 4Th Earl Of Gosford's paternal grandfather?	[Final Answer]: Ralph Neville, 3rd Earl of Westmorland.	Archibald Acheson, 2nd Earl of Gosford
Which film was released more recently, The First Seven Years or Cinesound Varieties?	[Final Answer]: The First Seven Years.	Cinesound Varieties
Where was the place of death of William De Warenne, 2Nd Earl Of Surrey's father?	[Final Answer]: Sussex	Lewes
What is the place of birth of the director of film I Love, You Love?	[Final Answer]: Bratislava	Bratislava
Do director of film Coteau Rouge and director of film Hochelaga, Land Of Souls share the same nationality?	[Final Answer]: Yes	yes
Where did the director of film Don Juan (1922 Film) die?	[Final Answer]: Westerland	Westerland
Where was the performer of song I See You (Theme From Avatar) born?	[Final Answer]: Leona Louise Lewis.	London
Who is the maternal grandmother of Archduchess Elisabeth Of Austria (1922–1993)?	[Final Answer]: Zita of Bourbon-Parma	Infanta Maria Antonia of Portugal
Which film was released more recently, Royal Treasure or When Love Begins?	[Final Answer]: Royal Treasure.	Royal Treasure
Who is Albert Iv, Prince Of Anhalt-Köthen's paternal grandfather?	[Final Answer]: Albert III, Count of Lindau-Ruppin.	Albert II, Prince of Anhalt-Zerbst
Which film has the director who was born later, Henry Goes Arizona or The Blue Collar Worker And The Hairdresser In A Whirl Of Sex And Politics?	[Final Answer]: Henry Goes Arizona	The Blue Collar Worker And The Hairdresser In A Whirl Of Sex And Politics
Who is the father of the director of film Plunkett & Macleane?	[Final Answer]: Ridley Scott	Ridley Scott
Who was born earlier, Ela Gandhi or Sebastián Borensztein?	[Final Answer]: Ela Gandhi.	Ela Gandhi
Which film has the director who was born earlier, Red Sparrow or The Flying Liftboy?	[Final Answer]: The Flying Liftboy	The Flying Liftboy
Which film was released first, The Cemetery Club or Uzhaikkum Karangal?	[Final Answer]: The Cemetery Club was released first, in 2006, while Uzhaikkum Karangal was released in 1976.	Uzhaikkum Karangal
Who is Wang Xijie's father-in-law?	[Final Answer]: Johann Ludwig von Westphalen	Longqing
What nationality is the director of film Rise Above: The Tribe 8 Documentary?	[Final Answer]: American.	United States
Who was born first out of Overill Dwyer-Brown and Dragan Načevski?	[Final Answer]: Overill Dwyer-Brown	Overill Dwyer-Brown
Which country the director of film I See You (2006 Film) is from?	[Final Answer]: India	India
Who is Colgú Mac Faílbe Flaind's uncle?	[Final Answer]: Faílbe Flann mac Áedo Duib	Fíngen mac Áedo Duib
Which country Gilduin Of Le Puiset's father is from?	[Final Answer]: France	France
Which film has the director who is older than the other, The Enchanted Desna or Neal Of The Navy? 	[Final Answer]: The Enchanted Desna	Neal Of The Navy
Which film has the director born later, Feel My Pulse or Panique?	[Final Answer]: Panique	Panique
Which film has the director who was born first, Hanuman Patal Vijay or Young And Dangerous: The Prequel?	[Final Answer]: Hanuman Patal Vijay	Hanuman Patal Vijay
Which film was released first, Heaven Help Us or Ghar Ki Rani?	[Final Answer]: Heaven Help Us	Ghar Ki Rani
Which film has the director who died first, The Boss And The Worker or Claire'S Knee?	[Final Answer]: Claire's Knee	The Boss And The Worker
Who lived longer, Louis-Armand-Constantin De Rohan or Adalberto Pereira Dos Santos?	[Final Answer]: Louis-Armand-Constantin De Rohan lived longer, dying in 1794, while Adalberto Pereira Dos Santos died in 1984.	Adalberto Pereira Dos Santos
Who is the mother-in-law of Gyrid Of Sweden?	[Final Answer]: Harald Bluetooth	Thyra
Who is the maternal grandfather of Prince Dmitri Alexandrovich Of Russia?	[Final Answer]: Grand Duke Xenia Alexandrovna of Russia	Alexander III of Russia
Where was the place of burial of the director of film The Last Company?	[Final Answer]: Havelland in Brandenburg.	Forest Lawn Memorial Park
Do both films Fig Leaves and Boogeyman (Film) have the directors that share the same nationality?	[Final Answer]: No. Howard Hawks was born in New Zealand, while Stephen Kay was born in the United States.	no
Which film has the director who is older, Road To Singapore or Melodies Of Vera Quarter?	[Final Answer]: Road To Singapore	Road To Singapore
Who is Prince Harald Of Schaumburg-Lippe's maternal grandfather?	[Final Answer]: Frederick VIII of Denmark	Prince Harald of Denmark
Where was the place of burial of Gjon Kastrioti Ii's father?	[Final Answer]: Daigo’s.	Lezhë
Who is Albert G. Simms's father-in-law?	[Final Answer]: Ruth Hanna McCormick	Mark Hanna
Which film has the director who was born first, Piccoli Fuochi or The Nice Guys?	[Final Answer]: Piccoli Fuochi	Piccoli Fuochi
Which film has the director who was born later, Playing It Wild or I'Ll Be Going Now?	[Final Answer]: I'll Be Going Now	I'Ll Be Going Now
Do both films, The Wild Frontier (Film) and The Sundowners (1960 Film), have the directors who are from the same country?	[Final Answer]: Yes, both films, The Wild Frontier (Film) and The Sundowners (1960 Film) have directors from the same country. Philip Ford directed The Wild Frontier and Fred Zinnemann directed The Sundowners, both being American directors.	yes
Which film has the director who was born later, Garde À Vue or Ivide Thudangunnu?	[Final Answer]: Garde À Vue	Garde À Vue
What nationality is Matilda Of Frisia's husband?	[Final Answer]: French	France
Who is Joan Of Valois, Duchess Of Alençon's maternal grandfather?	[Final Answer]: Charles of Valois	Charles VI of France
Where was the mother of Emilie Hegh Arntzen born?	[Final Answer]: Oslo	Oslo
Which film was released earlier, Extreme Ops or Puberun?	[Final Answer]: Puberun	Puberun
Which film has the director died earlier, Dynamite Smith or A Son Of Satan?	[Final Answer]: Dynamite Smith	Dynamite Smith
Which country the director of film West 32Nd is from?	[Final Answer]: American.	American
Who is Iynefer Ii's mother-in-law?	[Final Answer]: Nefertkau III.	Meresankh II
Which film has the director who was born first, En Kvinde Er Overflødig or Aakrosh (2010 Film)?	[Final Answer]: En Kvinde Er Overflødig	En Kvinde Er Overflødig
Who is Isma'Il Ibn Ja'Far's paternal grandmother?	[Final Answer]: Hubba bint Hulail	Farwah bint al-Qasim
Where was the director of film The 3 Rooms Of Melancholia born?	[Final Answer]: Pirjo Honkasalo	Helsinki
What is the place of birth of the director of film My Country'S Wings?	[Final Answer]: Santiago	Valparaíso
Where was the keyboardist of Xyz (English Band) born?	[Final Answer]: Kingsbury, London	Kingsbury, London
Where was the place of death of the director of film The Stone Rider?	[Final Answer]: Königstein im Taunus	Königstein im Taunus
When did Prince Gustav Of Thurn And Taxis (1848–1914)'s father die?	[Final Answer]: 10 November 1871	10 November 1871
Which film was released more recently, A Scream From Silence or Das Spielzeug Von Paris?	[Final Answer]: Das Spielzeug Von Paris	A Scream From Silence
Where was the mother of Elizabeth Of Denmark, Electress Of Brandenburg born?	[Final Answer]: Torgau	Torgau
Where was the director of film Aylwin (Film) born?	[Final Answer]: Weston-super-Mare, Somerset	Weston-super-Mare, Somerset
What is the date of death of Siemowit V Of Masovia's mother?	[Final Answer]: 17 May 1434	20 April 1434
Which film has the director died later, Sailor'S Luck or Lutaru Lalna?	[Final Answer]: Lutaru Lalna	Lutaru Lalna
Where did the director of film Barracuda (1978 Film) study?	[Final Answer]: Florida Atlantic University	Florida Atlantic
Where was the husband of Lou Henry Hoover born?	[Final Answer]: West Branch, Iowa.	West Branch, Iowa
What nationality is Julia Parker (Astrologer)'s husband?	[Final Answer]: English.	British
Who was born first, Emmanuel Goffi or Mariano Pasini?	[Final Answer]: Emmanuel Goffi	Emmanuel Goffi
Which one was established first, Besix or Circus Herman Renz?	[Final Answer]: BESIX	Besix
Which film was released earlier, Nesmrtelná Teta or Illang: The Wolf Brigade?	[Final Answer]: Nesmrtelná Teta	Nesmrtelná Teta
Where was the place of burial of Neith (Wife Of Pepi Ii)'s husband?	[Final Answer]: Mount Washington Cemetery, Independence Missouri.	Saqqara
Who was born later, Bradley Tyler Johnson or Bernardo Freitas?	[Final Answer]: Bernardo Freitas.	Bernardo Freitas
Do both films A Trial In Prague and Three Strangers have the directors that share the same nationality?	[Final Answer]: No. Zuzana Justman directed A Trial in Prague, and Jean Negulesco directed Three Strangers. Jean Negulesco was Romanian, while Zuzana Justman is Czech-American.	yes
Are Bilthoven and Herveld both located in the same country?	[Final Answer]: Yes	yes
Which country the composer of song Seconds (Song) is from?	[Final Answer]: Ireland	Irish
Where was the place of death of Princess Louise Auguste Of Denmark's mother?	[Final Answer]: Celle, Hanover	Celle
Who is the spouse of the director of film På Solsiden?	[Final Answer]: Arne Lie	Otto Carlmar
Which film has the director died later, Marriage In Name Only or Mille Chilometri Al Minuto!?	[Final Answer]: Marriage In Name Only	Marriage In Name Only
Who is the paternal grandfather of Yi Hong?	[Final Answer]: His Highness Prince Yi Seok	Prince Yi Kang
Who is the paternal grandfather of Sir Thomas Lawley, 3Rd Baronet?	[Final Answer]: Sir Thomas Lawley, 2nd Baronet	Sir Thomas Lawley, 1st Baronet
Who is the paternal grandfather of George Lyon, 5Th Lord Glamis?	[Final Answer]: John Lyon, 4th Lord Glamis	John Lyon, 3rd Lord Glamis
Where did the director of film Até Que A Sorte Nos Separe 2 study?	[Final Answer]: Roberto Santucci holds degrees for the Columbia College Hollywood and University of California.	University of California
Which film was released more recently, How To Make Love To A Negro Without Getting Tired or Frisco Kid?	[Final Answer]: How To Make Love To A Negro Without Getting Tired.	How To Make Love To A Negro Without Getting Tired
Who is the paternal grandmother of Jeanne Of Bar, Countess Of Marle And Soissons?	[Final Answer]: Jeanne de Bar, suo jure Countess of Marle and Soissons, Dame d'Oisy, Viscountess of Meaux, and Countess of Saint-Pol, of Brienne, de Ligny, and Conversano.	Marie I de Coucy, Countess of Soissons
Which film has the director who died later, September Affair or A Gathering Of Eagles?	[Final Answer]: September Affair	A Gathering Of Eagles
Which film was released more recently, Bidasari or Tangled Trails?	[Final Answer]: Tangled Trails	Bidasari
Which film has the director who is older, King Of The Zombies or Mon Oncle Benjamin?	[Final Answer]: King Of The Zombies	King Of The Zombies
Where does Kitty Dukakis's husband work at?	[Final Answer]: Northeastern University and UCLA.	UCLA
Which film came out first, Poznań '56 or The Last Day Of School Before Christmas?	[Final Answer]: Poznań '56	The Last Day Of School Before Christmas
Which film has the director died later, Saturday Night Out or An Italian Romance?	[Final Answer]: An Italian Romance.	An Italian Romance
Which film has the director born earlier, To Walk With Lions or The Grizzlies?	[Final Answer]: To Walk With Lions	To Walk With Lions
What nationality is Isabella Of England's mother?	[Final Answer]: English.	France
Which film has the director who is older, Villa!! or Sons Of Ingmar?	[Final Answer]: Villa!!	Sons Of Ingmar
Who lived longer, Huchtenburg or Benjamin Nottingham Webster?	[Final Answer]: Huchtenburg.	Huchtenburg
Where was the mother of Louise Sophie Of Hanau-Lichtenberg born?	[Final Answer]: Strasbourg	Strasbourg
Who was born later, Anna Margarete Stegmann or Mouloud Feraoun?	[Final Answer]: Anna Margarete Stegmann	Mouloud Feraoun
Who is the paternal grandmother of Prince Robert, Duke Of Chartres?	[Final Answer]: Louisa Jane Montagu Douglas Scott, Duchess of Buccleuch and Queensberry	Maria Amalia of Naples and Sicily
Who was born later, Ramón Corona or Ernest William Goodpasture?	[Final Answer]: Ernest William Goodpasture	Ernest William Goodpasture
Where was the place of death of the director of film Quatre-Vingt-Treize (Film)?	[Final Answer]: France	Paris
Are Flora Lake and Rostoul Lake located in the same country?	[Final Answer]: Yes	no
Who is Princess Florestine Of Monaco's paternal grandmother?	[Final Answer]: Florestan I	Louise d'Aumont
Which film was released more recently, Torrente 2: Misión En Marbella or The Heart Of New York (Film)?	[Final Answer]: Torrente 2: Misión En Marbella	Torrente 2: Misión En Marbella
Which film has the director born earlier, Main Tera Hero or Betrayed Women?	[Final Answer]: Main Tera Hero	Betrayed Women
Which album was released first, The Oak Ridge Boys Have Arrived or Beans And Fatback?	[Final Answer]: Beans And Fatback	Beans And Fatback
Which film whose director is younger, Slums Of Berlin or Phantom India?	[Final Answer]: Slums Of Berlin	Phantom India
Which film whose director was born first, Weird Woman or Secret Strings?	[Final Answer]: Weird Woman	Secret Strings
Who is the mother of the director of film Atomised (Film)?	[Final Answer]: Nina Hoss.	Gisela Elsner
When did Guglielma Pallavicini's mother die?	[Final Answer]: 1323	1323
Which film has the director died earlier, Black Belly Of The Tarantula or Devil On Deck?	[Final Answer]: Black Belly Of The Tarantula.	Devil On Deck
What is the date of birth of Mohammed Bin Nawwaf Bin Abdulaziz's father?	[Final Answer]: 22 May 1953	16 August 1932
What is the place of birth of the director of film Encino Man?	[Final Answer]: Albuquerque.	Albuquerque, New Mexico
Which film has the director born later, Song Of The Open Road or Campaign Of Hate: Russia And Gay Propaganda?	[Final Answer]: Song Of The Open Road	Campaign Of Hate: Russia And Gay Propaganda
Which film has the director who died later, The Olsen Gang In Jutland or Pathala Bhairavi?	[Final Answer]: The Olsen Gang In Jutland	The Olsen Gang In Jutland
Who is Marcus Aemilius Lepidus (Executed 39)'s father-in-law?	[Final Answer]: Caligula	Germanicus
Which film came out earlier, The Champion Of Pontresina or The Bulleteers?	[Final Answer]: The Bulleteers	The Champion Of Pontresina
Where was the place of burial of Kunigunde Of Poland's father?	[Final Answer]: Konopiště	Wawel Cathedral
Who is Charles Xiii Of Sweden's paternal grandfather?	[Final Answer]: Adolf Frederick	Christian August of Holstein-Gottorp, Prince of Eutin
Which country the performer of song I Might Have Been Queen is from?	[Final Answer]: United States.	Swiss
Who is the maternal grandfather of Conan Ii, Duke Of Brittany?	[Final Answer]: Alan I, King of Brittany	Odo II, Count of Blois
Where was the wife of Pierre-Marie Gault De Saint-Germain born?	[Final Answer]: Warsaw	Warsaw
Who is Henri Ii, Duke Of Nemours's paternal grandfather?	[Final Answer]: Philip II, Duke of Savoy	Jacques
Which film whose director was born first, Gangster'S Boy or Torno A Vivere Da Solo?	[Final Answer]: Gangster'S Boy	Gangster'S Boy
Which film was released more recently, Il Marchio Di Kriminal or Nandhi?	[Final Answer]: Nandhi	Nandhi
Where did Sultan Walad's father die?	[Final Answer]: Konya	Konya
Where was the director of film Mister Scarface born?	[Final Answer]: San Ferdinando di Puglia, Italy.	San Ferdinando di Puglia
Where was the place of death of Salin Mibaya's husband?	[Final Answer]: Pegu (Bago)	Pyay
Are Paris Sewer Museum and Musée National Des Douanes located in the same country?	[Final Answer]: Yes.	yes
Which film has the director died first, Let'S Live Again or Kummatty?	[Final Answer]: Let's Live Again	Let'S Live Again
Which film has the director who was born earlier, Thalapathi or Pour La Peau D'Un Flic?	[Final Answer]: Thalapathi	Pour La Peau D'Un Flic
Who is Tekle Haymanot Ii's paternal grandfather?	[Final Answer]: Kaya Alp	Iyasu I
Where was the place of burial of the director of film Broadway Bad?	[Final Answer]: Westwood Village Memorial Park Cemetery	Westwood Village Memorial Park Cemetery
What is the date of death of Matilda Of Boulogne, Duchess Of Brabant's mother?	[Final Answer]: 1182	25 July 1182
Are Xavier Catholic College, Llandilo and Toowoomba Anglican School located in the same country?	[Final Answer]: Yes	yes
What is the place of birth of the performer of song Are You Really Mine??	[Final Answer]: Camas, Washington	Camas
What nationality is Cecilia Renata Of Austria's husband?	[Final Answer]: Polish	Polish–Lithuanian Commonwealth
Which film has the director born first, 84 Charing Cross Road (Film) or Emperor'S Ball?	[Final Answer]: Emperor'S Ball	Emperor'S Ball
Do director of film Just Married (1934 Film) and director of film The Thirteenth Commandment share the same nationality?	[Final Answer]: Yes. Guido Brignone directed both Just Married (1934 Film) and The Thirteenth Commandment. Both were Italian directors.	yes
Who is the paternal grandfather of Eochaid Ailtlethan?	[Final Answer]: Ailill Caisfiaclach	Connla Cáem
Are Les Misérables (1917 Film) and The Better 'Ole (1926 Film) both from the same country?	[Final Answer]: Yes. Both Les Misérables (1917 Film) and The Better 'Ole (1926 Film) were made at Twickenham Studios, which is a British studio.	yes
What is the date of birth of Francis Otto, Duke Of Brunswick-Lüneburg's father?	[Final Answer]: 1530–1559	27 June 1497
Where was the director of film The Naked Angel born?	[Final Answer]: Santiago del Estero	Santiago del Estero
Which film was released first, Assault On Dome 4 or The Battle Of The Rails?	[Final Answer]: Assault on Dome 4	The Battle Of The Rails
Where was the place of burial of Pareherwenemef's mother?	[Final Answer]: The Valley of the Queens.	QV66
Who is the maternal grandfather of Princess Helena Adelaide Of Schleswig-Holstein-Sonderburg-Glücksburg?	[Final Answer]: Augustenborg palace	Frederick VIII, Duke of Schleswig-Holstein
Who was born later, Zhang Mengying or Wolfgang Herrndorf?	[Final Answer]: Wolfgang Herrndorf	Zhang Mengying
Which country Jessie Harlan Lincoln's father is from?	[Final Answer]: United States	American
Which film whose director is younger, Maine Pyaar Kyun Kiya? or Children Of The Streets?	[Final Answer]: Maine Pyaar Kyun Kiya	Maine Pyaar Kyun Kiya?
Where was the father of George Howard, 4Th Earl Of Suffolk born?	[Final Answer]: Suffolk	Saffron Walden
Which film has the director who was born later, Enjoy Yourselves or A Song To Remember?	[Final Answer]: Enjoy Yourselves	A Song To Remember
Where was the mother of Elizabeth Stafford born?	[Final Answer]: Geneva	English
What is the place of birth of the performer of song If You Want To Be My Woman?	[Final Answer]: Oildale, California	Bakersfield
Which film was released more recently, Hit Of The Show or The Incredibly Strange Creatures Who Stopped Living And Became Mixed-Up Zombies?	[Final Answer]: The Incredibly Strange Creatures Who Stopped Living And Became Mixed-Up Zombies.	The Incredibly Strange Creatures Who Stopped Living And Became Mixed-Up Zombies
Who is the spouse of the performer of song Neurotic Society (Compulsory Mix)?	[Final Answer]: Lauryn Noelle Hill	Rohan Marley
Where was the director of film Veera Thalattu born?	[Final Answer]: Chennai, India.	Theni
Which film has the director born later, Tell It To The Bees or House Of The Black Death?	[Final Answer]: House Of The Black Death	Tell It To The Bees
Which country the director of film Brecha (2009 Film) is from?	[Final Answer]: Spain.	Argentine
Where was the place of death of the director of film Basta Guardarla?	[Final Answer]: Rome	Rome
Which film has the director who died earlier, The Third Visitor or The Dangerous Dude?	[Final Answer]: The Third Visitor	The Third Visitor
Who is the spouse of the director of film Min Kone Er Uskyldig?	[Final Answer]: Poul Reichhardt	Annelise Hovmand
Which film has the director born earlier, Amityville 3-D or The Soul'S Cycle?	[Final Answer]: Amityville 3-D	The Soul'S Cycle
Where was the husband of Princess Alexandra Of Anhalt born?	[Final Answer]: British.	Rudolstadt
Which film has the director who died later, Bloody Moon or The House Of Pulcini?	[Final Answer]: Bloody Moon	Bloody Moon
Which film was released more recently, Behind Locked Doors or Crossing Delancey?	[Final Answer]: Behind Locked Doors.	Crossing Delancey
Are both directors of films The Black Corsair (1937 Film) and Paths Of War from the same country?	[Final Answer]: Yes. Amleto Palermi and Aldo Grimaldi are both directors from Italy.	yes
Which film whose director is younger, Beat Girl or The White Squaw?	[Final Answer]: Beat Girl	Beat Girl
Which film has the director died earlier, Remember The Day or Cast Up By The Sea?	[Final Answer]: Remember The Day	Cast Up By The Sea
Which country Princess Katherine Of Greece And Denmark's mother is from?	[Final Answer]: Russia	German
Where was the director of film House In The Sun born?	[Final Answer]: Béziers, Hérault	Béziers
Do the movies Sweet Mama (Film) and Soy Andina, originate from the same country?	[Final Answer]: Yes. Soy Andina is an American documentary film, and Sweet Mama is a Canadian rock album.	yes
Where does the director of film Die Abfahrer work at?	[Final Answer]: Los Angeles County Museum of Art	Dortmund University of Applied Sciences and Arts
Who is the paternal grandmother of Charles Stuart, 1St Earl Of Lennox?	[Final Answer]: Margaret Douglas	Elizabeth Stewart
What is the cause of death of director of film She Asked For It?	[Final Answer]: Parkinson's disease.	Parkinson
Who is Maurice De Berkeley, 4Th Baron Berkeley's maternal grandfather?	[Final Answer]: Richard de Beauchamp, 13th Earl of Warwick	Roger Mortimer, 1st Earl of March
Which country Æthelwald, Ealdorman Of East Anglia's wife is from?	[Final Answer]: West Saxon.	English
Which film whose director is younger, Vadakakku Oru Hridayam or The $1,000,000 Reward?	[Final Answer]: Vadakakku Oru Hridayam. I. V. Sasi, the director of Vadakakku Oru Hridayam, was born in 1948, while George Lessey, the director of The $1,000,000 Reward, was born in 1879.	Vadakakku Oru Hridayam
Where was the director of film Blood Father born?	[Final Answer]: Jean-François Richet.	Paris
Who is the spouse of the director of film Zabak?	[Final Answer]: Shyama	Fearless Nadia
Which film has the director who died later, Valentin The Good or A Daughter Of Two Worlds?	[Final Answer]: Valentin The Good	Valentin The Good
Where was the father of Maurice De Saxe born?	[Final Answer]: Saxony	Dresden
Which film has the director who was born later, Til Sæters or Ruben Guthrie?	[Final Answer]: Til Sæters	Ruben Guthrie
Who was born later, Tsvetko Slavov or Marc Burrows?	[Final Answer]: Tsvetko Slavov	Marc Burrows
Who is Alexandra Of Lithuania's father-in-law?	[Final Answer]: Siemowit IV, Duke of Masovia.	Siemowit III, Duke of Masovia
What is the place of birth of the director of film The Blue And White Lion?	[Final Answer]: Berlin	Berlin
Which film has the director who died later, The Monkey Talks or Varakatnam?	[Final Answer]: The Monkey Talks	Varakatnam
What nationality is Claire Annabel Caroline Grant Duff's father?	[Final Answer]: British	British
Where was the place of death of Princess Anne Charlotte Of Lorraine's mother?	[Final Answer]: Remiremont	Commercy
Who was born first out of Pierre Gauvreau and Tit Liviu Chinezu?	[Final Answer]: Pierre Gauvreau	Tit Liviu Chinezu
When is Princess Joséphine Marie Of Belgium's mother's birthday?	[Final Answer]: 30 November 1870	17 November 1845
Who is Infante Philip, Duke Of Calabria's paternal grandmother?	[Final Answer]: Maria Amalia of Saxony.	Elisabeth Farnese
Where was the place of death of the director of film We (1982 Film)?	[Final Answer]: Přerov	Přerov
Which album came out first, Sol Niger Within or The Magic Place?	[Final Answer]: Sol Niger Within	Sol Niger Within
Which country the director of film Downloaded (Film) is from?	[Final Answer]: United States.	American
Are The Finches and She Drew The Gun both from the same country?	[Final Answer]: No. The Finches are from San Francisco, California, while She Drew the Gun is from Wirral, England.	no
Where did Joanna, Duchess Of Durazzo's mother die?	[Final Answer]: Castel dell’Ovo in Naples.	Neapolitan
Who is the father-in-law of Ri Sol-Ju?	[Final Answer]: Kim Jong-un	Kim Jong-il
Which film has the director died later, All The Sins Of The Earth or Women In The Wind?	[Final Answer]: All The Sins Of The Earth	All The Sins Of The Earth
Who was born first, Patrik Lácha or Brad Booth?	[Final Answer]: Patrik Lácha	Brad Booth
Where was the place of death of Lin Liguo's father?	[Final Answer]: Mongolia	Öndörkhaan
Where was the place of death of the director of film Valley Of The Giants (Film)?	[Final Answer]: New York, New York.	New York
Who is younger, Jonetani Ralulu or Andre Blay?	[Final Answer]: Jonetani Ralulu	Jonetani Ralulu
Who is Fernando Rodríguez De Castro's paternal grandfather?	[Final Answer]: Fernando Gutiérrez de Castro.	Fernando García de Hita
Which film came out earlier, Gran Torino or Rivaaj?	[Final Answer]: Gran Torino	Rivaaj
Which film has the director who died first, Everybody'S Hobby or One Sunday Afternoon (1948 Film)?	[Final Answer]: Everybody'S Hobby	Everybody'S Hobby
Where was the director of film The Wedding Video (2003 Film) born?	[Final Answer]: Norman Korpi.	American
Who is Sir William Gore, 3Rd Baronet's paternal grandfather?	[Final Answer]: Sir Ralph Gore, 2nd Baronet	Sir Paul Gore, 1st Baronet
Who is the mother of the founder of university Libera Università Internazionale Degli Studi Sociali Guido Carli?	[Final Answer]: Virginia Agnelli (born Donna Virginia Bourbon del Monte)	Virginia Bourbon del Monte
Who is the spouse of the director of film Worldly Goods?	[Final Answer]: Agnes Ayres	Jean Harlow
What nationality is the director of film Vortex (1976 Film)?	[Final Answer]: Italian-French.	Italy
Where was the place of death of Elisabeth Of Moravia's mother?	[Final Answer]: Brno	Brno
Who was born later, Charles Burls or George Hypolite?	[Final Answer]: George Hypolite	George Hypolite
Who is the maternal grandfather of Princess Louise Of Belgium?	[Final Answer]: Leopold II	Archduke Joseph, Palatine of Hungary
Which film was released more recently, Horas Marcadas or Tiny Times 3?	[Final Answer]: Tiny Times 3	Tiny Times 3
Who is the paternal grandfather of Sultan Al-Dawla?	[Final Answer]: Abu Kalijar Marzuban	'Adud al-Dawla
Where did Mate Meštrović's father graduate from?	[Final Answer]: The University of Syracuse.	Academy of Fine Arts Vienna
Which country the director of film Funny Games (2007 Film) is from?	[Final Answer]: Austria.	Austrian
Where does the composer of film Rivers And Tides work at?	[Final Answer]: composer Frith	Mills College
What nationality is the director of film Top Floor Girl?	[Final Answer]: French-born Australian.	French
Where did the director of film Polish-Russian War (Film) study?	[Final Answer]: National Film School in Łódź.	National Film School in Łódź
Where did Roberto Civita's father die?	[Final Answer]: Beaulieu- sur- Loire	São Paulo
What is the date of death of Fitzroy Somerset, 5Th Baron Raglan's father?	[Final Answer]: 24 January 2010	14 September 1964
What is the place of birth of the director of film Martial Law (1991 Film)?	[Final Answer]: Steve Cohen	Memphis
Which film was released more recently, Last Of The Long-Haired Boys or Age Of The Dragons?	[Final Answer]: Age Of The Dragons	Age Of The Dragons
Which film was released more recently, How Poets Are Enjoying Their Lives or Os Faroleiros?	[Final Answer]: How Poets Are Enjoying Their Lives.	How Poets Are Enjoying Their Lives
What is the place of birth of John F. Kennedy Jr.'s mother?	[Final Answer]: Southampton, New York	Southampton
Are both Flying Fifty-Five and Approaching Midnight from the same country?	[Final Answer]: No. Approaching Midnight was filmed in Michigan, United States, while Flying Fifty-Five was filmed in Welwyn Studios, United Kingdom.	no
What nationality is the director of film Detachment (Film)?	[Final Answer]: British.	British
Where does the director of film Podokkhep work at?	[Final Answer]: Suman Ghosh	Florida Atlantic
Where does David Flair's father work at?	[Final Answer]: World Championship Wrestling (WCW).	Total Nonstop Action Wrestling
Are Half Mile Lagoon and Lake Waitaki both located in the same country?	[Final Answer]: Yes	yes
Who was born first out of Misaele Draunibaka and Ross Clark?	[Final Answer]: Misaele Draunibaka.	Ross Clark
What is the date of birth of Augustus Paulet, 15Th Marquess Of Winchester's father?	[Final Answer]: 1858	3 June 1801
Where was the father of Nigel De Brus born?	[Final Answer]: Carrick, Ayrshire, Scotland	Writtle
Who is Hye Of Baekje's paternal grandfather?	[Final Answer]: Kızıl Buğa	Muryeong
Are Car Trouble (Film) and White Heat (1926 Film) both from the same country?	[Final Answer]: Yes. Car Trouble is a British film, while White Heat (1926 Film) is a British film.	yes
Which film has the director who is older, Dialogues Of Exiles or Rhythm And Weep?	[Final Answer]: Rhythm And Weep	Rhythm And Weep
Who is older, William Henry Rodes Green or Eleanor Of Lancaster?	[Final Answer]: William Henry Rodes Green	Eleanor Of Lancaster
Which film has the director who died earlier, In The First Degree or The Sea God?	[Final Answer]: The Sea God	In The First Degree
Who is the paternal grandfather of Gilbert De Umfraville, Earl Of Angus?	[Final Answer]: Richard de Umfraville	Richard de Umfraville
Who is the paternal grandmother of Reinald Iv, Duke Of Guelders And Jülich?	[Final Answer]: Sophie Berthout, lady of Malines.	Joanna of Hainaut
Which film has the director who died first, Another Language or Les Tontons Flingueurs?	[Final Answer]: Another Language	Another Language
Who is the paternal grandmother of Arthur Gore, 1St Earl Of Arran?	[Final Answer]: Elizabeth Annesley	Anne Gore
Which film was released earlier, Farewell To The King or Brother Liu And Brother Wang On The Roads In Taiwan?	[Final Answer]: Brother Liu And Brother Wang On The Roads In Taiwan	Brother Liu And Brother Wang On The Roads In Taiwan
Who lived longer, Bernhard Afinger or Melvin Kranzberg?	[Final Answer]: Bernhard Afinger lived longer, from 1813 to 1882, while Melvin Kranzberg died in 1995.	Melvin Kranzberg
What is the place of birth of the director of film Samarpane?	[Final Answer]: The information does not state the place of birth of the director of Samarpane (H. R. Bhargava).	Hunsur
Where was the father of Princess Amelia Of Great Britain born?	[Final Answer]: Túrkeve	Hanover
Where did Rudra Mohammad Shahidullah's wife study at?	[Final Answer]: The provided text does not contain information about Rudra Mohammad Shahidullah’s wife’s studies.	Mymensingh Medical College
Are Walter E. Massey and Matt Horwich both from the same country?	[Final Answer]: Yes	yes
What is the place of birth of the director of film A Gun & A Ring?	[Final Answer]: Toronto, Ontario, Canada	Jaffna, Sri Lanka
Who is Albert Iii, Prince Of Anhalt-Zerbst's paternal grandfather?	[Final Answer]: Rudolf I, Elector of Saxony and Duke of Saxe-Wittemberg	Albert I, Prince of Anhalt-Zerbst
Where did Judith Of Swabia's mother die?	[Final Answer]: Quedlinburg	Roman
Where was the place of burial of Karomama I's husband?	[Final Answer]: Thebes	Tanis
Which award the performer of song Beating Heart (Ellie Goulding Song) got?	[Final Answer]: Brit Awards in the same year.	BRIT Awards
What nationality is Prince Napoléon Bonaparte's father?	[Final Answer]: Jerome, King of Westphalia.	French
Where was the founder of magazine Track & Field News born?	[Final Answer]: San Diego, California.	San Diego
Why did the director of film Normande (Film) die?	[Final Answer]: Gilles Carle died aged 81 on November 28, 2009 of complications from Parkinson's disease at the hospital in Granby, Quebec.	Parkinson's disease
Which film has the director born later, The Man Who Murdered or Newness?	[Final Answer]: The Man Who Murdered.	Newness
Where did the director of film The Price Of Everything study?	[Final Answer]: Yale University.	Yale
What is the place of birth of the director of film Venus Makes Trouble?	[Final Answer]: St. Louis, Missouri	Jerseyville
Which film has the director who was born later, Meraa Dost Meraa Dushman or Miles From Home?	[Final Answer]: Meraa Dost Meraa Dushman.	Miles From Home
Which film has the director born earlier, Pieces Of A Woman or Oriental Nights?	[Final Answer]: Oriental Nights	Oriental Nights
Was Dudley Russell or Juan René Serrano born first?	[Final Answer]: Juan René Serrano	Dudley Russell
Which film has the director who died later, The Lady Owner or Behind Prison Gates?	[Final Answer]: The Lady Owner	Behind Prison Gates
Who is Olga Constantinovna Of Russia's maternal grandfather?	[Final Answer]: Grand Duke Constantine Nikolaievich	Joseph, Duke of Saxe-Altenburg
Which film has the director died later, Taipei Story or The Ballad Of Cossack Golota?	[Final Answer]: Taipei Story	Taipei Story
Where did Oleg Kerensky's father die?	[Final Answer]: London	New York
Who died earlier, Chiang Chung-Ling or George Andreadis?	[Final Answer]: Chiang Chung-Ling	Chiang Chung-Ling
Where was the husband of Mok Kwai-Lan born?	[Final Answer]: The information does not state where the husband of Mok Kwai-lan was born.	Foshan
Did the movies Afraid Of The Dark and Smiley (2012 Film), originate from the same country?	[Final Answer]: No. “Afraid of the Dark” is a French-British film, while “Smiley” (2012 Film) is an American slasher horror film.	no
Are both Enmelen and Yelshanka located in the same country?	[Final Answer]: Yes	yes
What is the cause of death of performer of song Blues Run The Game?	[Final Answer]: pneumonia.	pneumonia
Are Freestylers and The Nouvelles both from the same country?	[Final Answer]: Yes	yes
Which film has the director who was born later, Eradu Rekhegalu or The Gentleman From Nowhere?	[Final Answer]: Eradu Rekhegalu	Eradu Rekhegalu
Who is Eleanor Of England, Countess Of Leicester's paternal grandmother?	[Final Answer]: John, King of England.	Eleanor of Aquitaine
Where was the director of film I'Ll Follow You Down born?	[Final Answer]: Canada	Mississauga
Where was the place of burial of Princess Barbara Of Prussia's father?	[Final Answer]: Daigo	Esparza
Which film has more directors, A Night Of Horror or The Whispering Shadow?	[Final Answer]: A Night Of Horror	A Night Of Horror
Who is younger, Vedran Purić or Jenő Kuti?	[Final Answer]: Vedran Purić	Vedran Purić
Which film has the director died first, To Mary – With Love or Five Little Peppers And How They Grew?	[Final Answer]: To Mary – With Love	To Mary – With Love
Which film has the director born later, Where Are You? I'M Here or 11 Flowers?	[Final Answer]: Liliana Cavani	11 Flowers
Who is Countess Alexandra Von Zarnekau's paternal grandmother?	[Final Answer]: Duke Peter Georgievich of Oldenburg	Princess Therese of Nassau-Weilburg
Which film was released earlier, Gangai Karai Paattu or God In Heaven... Arizona On Earth?	[Final Answer]: Gangai Karai Paattu	God In Heaven... Arizona On Earth
Where did Elisabeth Of Hesse, Electress Palatine's mother die?	[Final Answer]: Lauingen	Kassel
What is the place of birth of the performer of song Thru Your Phone?	[Final Answer]: Manhattan	Bronx
Where did Ulysses S. Grant Jr.'s father graduate from?	[Final Answer]: West Point	Army
Are the movies Amy (2015 Film) and Manhattan Angel, from the same country?	[Final Answer]: Yes. “Amy” (2015 Film) and “Manhattan Angel” were both released theatrically in the United Kingdom and the United States.	no
What is the date of birth of Marie Jeanne Baptiste Of Savoy-Nemours's husband?	[Final Answer]: 11 April 1644	20 June 1634
Where was the director of film Rocket Attack U.S.A. born?	[Final Answer]: Bakersfield	Bakersfield, California
When was the composer of song Hot Time In The Town Of Berlin born?	[Final Answer]: 1916	November 7, 1916
Where was the place of burial of Lorenzo Cybo's mother?	[Final Answer]: Rome	St. Peter's Basilica
Are the directors of films Back To Back (1996 Film) and The White Hen both from the same country?	[Final Answer]: No. One director of Back To Back (1996 Film) is Roger Nygard, who is American, while the director of The White Hen is Frank Richardson, who is British.	yes
Where was the director of film Katka'S Reinette Apples born?	[Final Answer]: Rēzekne	Rēzekne
Who is the paternal grandmother of Renaud Iii, Count Of Soissons?	[Final Answer]: Adelaide	Adelaide, Countess of Soissons
Who is George Frederick, Count Of Erbach-Breuberg's paternal grandfather?	[Final Answer]: Eberhard XII, Count of Erbach-Freienstein	George III, Count of Erbach-Breuberg
Which film has the director died later, Dissolved And Effused or Here Comes The Groom?	[Final Answer]: Dissolved And Effused	Dissolved And Effused
What is the place of birth of the director of film Chronicles Of A Dive Bomber?	[Final Answer]: Canberra	Leningrad
What nationality is the singer of Pre (Band)?	[Final Answer]: Japanese.	Japan
Who is Anna Of Nassau-Dillenburg (1541–1616)'s maternal grandmother?	[Final Answer]: Juliana of Stolberg.	Anna of Eppstein-Königstein
Which film has the director who was born later, Fugitive Rage or Neapolitan Carousel?	[Final Answer]: Fugitive Rage	Fugitive Rage
Who is the father-in-law of Prince Feodor Alexandrovich Of Russia?	[Final Answer]: Princess Irina Pavlovna Paley	Grand Duke Paul Alexandrovich of Russia
Where did the director of film Battle Taxi die?	[Final Answer]: Moreno Valley, California	Moreno Valley
Are the directors of both films I Can'T Marry Them All and Come To The Stable from the same country?	[Final Answer]: Yes. Henry Koster directed both films.	yes
Who was born first out of Johan Bardoul and Peter Seton Hay?	[Final Answer]: Johan Bardoul	Peter Seton Hay
When did Philip Iii, Marquis Of Namur's father die?	[Final Answer]: 1337	31 January 1330
Who was born first out of Adnen Helali and Maria Poulsen?	[Final Answer]: Adnen Helali.	Adnen Helali
Which film came out first, Legend Of The Sea Wolf or Irvine Welsh'S Ecstasy?	[Final Answer]: Legend Of The Sea Wolf	Legend Of The Sea Wolf
Are both Lise Kristiansen and Bernt Lund from the same country?	[Final Answer]: Yes.	yes
What nationality is Kham Keut's father?	[Final Answer]: Thai	Lao
Where did the director of film 29+1 study?	[Final Answer]: Paris Studio Magenia	Hong Kong Academy for Performing Arts
Which film came out earlier, Desam or The Legend Of Paul And Paula?	[Final Answer]: Desam	The Legend Of Paul And Paula
Are the movies Seeing Red (1992 Film) and Wind From The Icy Country, from the same country?	[Final Answer]: Yes. Seeing Red (1992 Film) and Wind From The Icy Country are both Australian films.	yes
Are both mountains, Kunturwasa and Yerupaja Chico, located in the same country?	[Final Answer]: Yes. Kunturwasa and Yerupaja Chico are both located in Peru.	yes
Which country the director of film Secrets Of A Door-To-Door Salesman is from?	[Final Answer]: Germany	United Kingdom
Where does the director of film The Witnesses work at?	[Final Answer]: Paris	Cahiers du cinéma
Which film has the director who was born later, Young Buffalo Bill or The Lacquered Box?	[Final Answer]: Young Buffalo Bill	Young Buffalo Bill
What is the cause of death of director of film The Street Of Illusion?	[Final Answer]: Parkinson's disease.	Parkinson
Who was born first, Thomas Rolfe or Roger Miret?	[Final Answer]: Thomas Rolfe	Thomas Rolfe
Where was the father of Benjamin Lewis Vulliamy born?	[Final Answer]: Britain	London
Where did the director of film Bridge Over The Elbe die?	[Final Answer]: Madrid	Madrid
Where did the director of film Mary Jane'S Pa die?	[Final Answer]: New York, New York	New York
Who lived longer, Claes-Ulrik Winberg or André Piters?	[Final Answer]: Claes-Ulrik Winberg	André Piters
What is the place of birth of Danielle Lineker's husband?	[Final Answer]: Wales	Leicester
Who is the father-in-law of Graham Smith (Māori Academic)?	[Final Answer]: Linda Tuhiwai Te Rina Smith	Hirini Moko Mead
Where was the father of Gwen Graham born?	[Final Answer]: Coral Gables, Florida	Coral Gables, Florida
Which country François Louis, Prince Of Conti's father is from?	[Final Answer]: France	French
What nationality is the composer of film Count Your Blessings (1959 Film)?	[Final Answer]: German.	German
Where did the director of film A Daughter Of Two Worlds die?	[Final Answer]: New York, New York.	New York
Which film has the director who is older, This Love Of Ours or The Red Siren?	[Final Answer]: This Love Of Ours	This Love Of Ours
Was Ralf Wohlleben or Ilya Tyapkin born first?	[Final Answer]: Ilya Tyapkin.	Ralf Wohlleben
Which film has the director who is older than the other, One Woman To Another or Come On, Rangers? 	[Final Answer]: One Woman To Another	One Woman To Another
Which film has the director born earlier, Helluva Good Luck or The Last House On The Beach?	[Final Answer]: Helluva Good Luck. Zdeněk Troška was born on May 18, 1953, while Franco Prosperi was born on September 2, 1926.	The Last House On The Beach
Which university was established first, Universidad Autónoma De La Laguna or Penang Free School?	[Final Answer]: Universidad Autónoma De La Laguna	Penang Free School
Where was the performer of song Det Brinner Ett Ljus born?	[Final Answer]: Stefan Borsch	Hagfors
Who is Wenceslaus Of Żagań's paternal grandfather?	[Final Answer]: Rudolf III, Duke of Saxe-Wittemberg and Elector of Saxony.	Henry VIII the Sparrow
Do both directors of films Assassin'S Creed (Film) and Two Brothers Running have the same nationality?	[Final Answer]: No, Justin Kurzel and Ted Robinson have different nationalities. Kurzel was born in Gawler, South Australia, while Ted Robinson is an Australian television producer and director who is best known for his work and a director and producer of live TV comedy.	yes
Do both films: America Ammayi and Professor Pyarelal have the directors from the same country?	[Final Answer]: Yes, both America Ammayi and Professor Pyarelal have directors from the same country, which is India. Singeetam Srinivasa Rao directed America Ammayi, and Brij Sadanah directed Professor Pyarelal.	yes
Where was the director of film Naked Violence (Film) born?	[Final Answer]: San Ferdinando di Puglia	San Ferdinando di Puglia
What is the date of birth of Archduke Karl Pius Of Austria, Prince Of Tuscany's mother?	[Final Answer]: 7 September 1868	7 September 1868
Which film has the director died earlier, The Romantic Age or Anything Once?	[Final Answer]: The Romantic Age. Edmond T. Gréville, the director of The Romantic Age, died in 1966, while Joe De Grasse, the director of Anything Once, died in 1917.	Anything Once
Are Salla Huancane and Ichhu Rutuna located in the same country?	[Final Answer]: Yes.	yes
Who is the maternal grandmother of Isabel De Verdun, Baroness Ferrers Of Groby?	[Final Answer]: Elizabeth de Clare.	Joan of Acre
Which film has the producer died earlier, The Criminal (1960 Film) or A Soldier'S Oath?	[Final Answer]: The Criminal (1960 Film)	A Soldier'S Oath
What is the place of birth of William Parr, 1St Marquess Of Northampton's mother?	[Final Answer]: Harrowden	Northamptonshire
What is the place of birth of Princess Lalla Meryem Of Morocco's mother?	[Final Answer]: Rome.	Khenifra
Who is Louis Viii, Landgrave Of Hesse-Darmstadt's paternal grandmother?	[Final Answer]: Dorothea Charlotte of Brandenburg-Ansbach	Elisabeth Dorothea of Saxe-Gotha-Altenburg
Where was the performer of song Suicide Social born?	[Final Answer]: French.	Alençon
Which film has the director died first, Forty Years or Two Mules For Sister Sara?	[Final Answer]: Forty Years or Veertig Jaren	Forty Years
Who is the maternal grandfather of Agnès Of Navarre?	[Final Answer]: Louis X of France	Louis X of France
Where was the place of death of the performer of song The Village Of St. Bernadette (Song)?	[Final Answer]: Tarbes–Lourdes–Pyrénées Airport	Branson, Missouri
What nationality is Nawrahta Minsaw's father?	[Final Answer]: Burmese	Toungoo Empire
Where did the composer of film Port Djema study?	[Final Answer]: The Peabody Conservatory of Music	Peabody Conservatory
Where was the place of death of the director of film A Man, A Woman, And A Bank?	[Final Answer]: Santa Monica, California	Santa Barbara, California
Which film has the director who was born later, Maneater Of Hydra or The Fighting Seabees?	[Final Answer]: Maneater Of Hydra	Maneater Of Hydra
When was the company that published The Rip Off Review Of Western Culture founded?	[Final Answer]: 1969	1969
When is the founder of university Vermont Studio Center 's birthday?	[Final Answer]: January 26, 1955	January 26, 1955
Which film has the director who died earlier, Macario Against Zagomar or The Galloping Fish?	[Final Answer]: Macario Against Zagomar	The Galloping Fish
Where was the place of death of the director of film Never The Twain (Film)?	[Final Answer]: Hamburg	Hamburg, Germany
Who died first, Marguerite De Navarre or Leo Lankinen?	[Final Answer]: Marguerite De Navarre	Marguerite De Navarre
Which award the director of film Swapnabhumi earned?	[Final Answer]: Ekushey Padak	Ekushey Padak
Where did Elizabeth Tudor (1492–1495)'s mother die?	[Final Answer]: England	Tower
What is the place of birth of Claudia Rodríguez De Castellanos's husband?	[Final Answer]: Bogotá	Bogotá
Are both mountains, Yana Urqu (Q'Umirqucha) and Puka Rumi, located in the same country?	[Final Answer]: Yes.	yes
Which film has the director born earlier, The Belle Of Broadway or Count Varenne'S Lover?	[Final Answer]: Count Varenne's Lover	Count Varenne'S Lover
Which film has the director died first, Hit Parade Of 1943 or Mr. Reeder In Room 13?	[Final Answer]: Mr. Reeder In Room 13.	Mr. Reeder In Room 13
Which film came out earlier, To Touch The Soul or Contragolpe?	[Final Answer]: To Touch The Soul	Contragolpe
When did John Brabazon, 10Th Earl Of Meath's father die?	[Final Answer]: 4 January 1790	4 January 1790
Which film has the director who was born first, Legend Of The Mountain or Three Men To Kill?	[Final Answer]: Legend Of The Mountain	Three Men To Kill
Where was the place of burial of Cecilia Maria De Candia's mother?	[Final Answer]: Père Lachaise Cemetery in Paris.	Père Lachaise Cemetery
Who is Adolf, Duke Of Bavaria's maternal grandfather?	[Final Answer]: Adolph I, Duke of Cleves	Adolph I
Where did Elizabeth Bruce's father die?	[Final Answer]: Robert the Bruce	Cardross
Where did the director of film The Cloister Of Martins die?	[Final Answer]: Grünwald, Germany.	Munich
Who is Grimoald The Younger's paternal grandfather?	[Final Answer]: Pepin of Herstal	Ansegisel
Are both bands, The Renegades (Band) and Second Hand (Band), from the same country?	[Final Answer]: No, The Renegades (Band) is from Britain, while Second Hand (Band) is from Russia.	yes
Where was the director of film Bewitching Kisses born?	[Final Answer]: Vicente López, Gran Buenos Aires.	Buenos Aires
Who is Ailwyn Fellowes, 1St Baron Ailwyn's paternal grandfather?	[Final Answer]: Richard Colley Wesley, 1st Baron Mornington	William Henry Fellowes
Which film has the director who is older, Clash By Night or Porn In The Hood?	[Final Answer]: Clash By Night	Clash By Night
Where was the performer of song Remember (John Lennon Song) born?	[Final Answer]: Liverpool	Liverpool
Who was born first out of Eliza Ritchie and Benjamin Nash?	[Final Answer]: Eliza Ritchie	Benjamin Nash
What is the date of birth of Teddy Hart's father?	[Final Answer]: B.J. Annis was born on December 26, 1956.	1947
Did Lenny Mcallister and Ken Xie have the same nationality?	[Final Answer]: No. Lenny McAllister is an American political commentator, while Ken Xie is a Chinese-born American businessman.	yes
Which album came out first, Kind Of Love or Around The Fur?	[Final Answer]: Kind Of Love	Kind Of Love
Who died earlier, Charles Taze Russell or George Washington Bright?	[Final Answer]: Charles Taze Russell	Charles Taze Russell
Who is Prince Hubertus Of Prussia's maternal grandfather?	[Final Answer]: Frederick Francis III, Grand Duke of Mecklenburg-Schwerin	Frederick Francis III, Grand Duke of Mecklenburg-Schwerin
Where was the place of burial of the director of film The Secret Of Dr. Kildare?	[Final Answer]: Glendale's Forest Lawn Memorial Park Cemetery.	Forest Lawn Memorial Park
What is the date of death of Frederick Michael, Count Palatine Of Zweibrücken's father?	[Final Answer]: 15 August 1767	3 February 1735
Who is Gaius Rubellius Blandus's father-in-law?	[Final Answer]: Seneca the Younger.	Drusus Julius Caesar
Which film was released earlier, Mercadet or Nangna Kappa Pakchade?	[Final Answer]: Mercadet	Mercadet
Which film has the director born earlier, I Learned It From Father or Sengottai Singam?	[Final Answer]: I Learned It From Father	I Learned It From Father
Where was the place of death of the director of film Fight Of The Tertia (1952 Film)?	[Final Answer]: Kreuth-Weißach	Kreuth
Where was the husband of Dobrodeia Of Kiev born?	"[Final Answer]: Balabista (today ""Sidirokastro"")"	Macedonia
Who is the paternal grandfather of Casimir Ii Of Zator?	[Final Answer]: Casimir I of Kuyavia.	Casimir I of Oświęcim
Which film has the director who died later, Stolen Identity or Them!?	[Final Answer]: Stolen Identity	Them!
What is the place of birth of the performer of song Git (Song)?	[Final Answer]: Kırklareli	Kırklareli
Where was the place of death of the director of film Muchachos De La Ciudad?	[Final Answer]: Vicente López, Gran Buenos Aires.	Buenos Aires
What is the place of birth of Jehu Grubb's father?	[Final Answer]: Stark County, Ohio	Pennsylvania
Who is the sibling-in-law of Marie Thérèse De Choiseul?	[Final Answer]: Prince Joseph of Monaco	Honoré IV, Prince of Monaco
Where was the father of Islam Shah Suri born?	[Final Answer]: Sasaram in modern-day Bihar.	Sasaram
When was Ellen Roosval Von Hallwyl's mother born?	[Final Answer]: 1844	1 October 1844
Which country Marie Antoinette Murat's husband is from?	[Final Answer]: Hohenzollern-Sigmaringen	German
Which film has the director who died later, Taxi! or What Price Hollywood??	[Final Answer]: Taxi!	What Price Hollywood?
Which film has the director who was born first, La Môme Vert-De-Gris or The Pod People?	[Final Answer]: La Môme Vert-De-Gris	La Môme Vert-De-Gris
Who died later, A. V. Aryan or Sadie Heath Cabaniss?	[Final Answer]: A. V. Aryan	A. V. Aryan
Which film was released earlier, Son Contento or Tadbir?	[Final Answer]: Son Contento	Tadbir
Which film has the director who is older than the other, Chinese In Paris or March Of The Penguins? 	[Final Answer]: March Of The Penguins	Chinese In Paris
Who is the spouse of the director of film Marie-Jo And Her Two Lovers?	[Final Answer]: Robert Guédiguian	Ariane Ascaride
Where was the place of death of Johanna Sibylla Of Hanau-Lichtenberg's mother?	[Final Answer]: Runkel	Bouxwiller
Who is the spouse of the performer of song Pump-Pump?	[Final Answer]: Eva-Riitta Siitonen.	Eva-Riitta Siitonen
Who was born first out of Marie Agba-Otikpo and Mariam El-Masri?	[Final Answer]: Marie Agba-Otikpo	Marie Agba-Otikpo
Who is the father of the director of film Little Joe (Film)?	[Final Answer]: Jessica Hausner	Rudolf Hausner
Are Six Dance Lessons In Six Weeks (Film) and Article 99 both from the same country?	[Final Answer]: No. Six Dance Lessons in Six Weeks (Film) is a 2014 Hungarian-American film, while Article 99 is an American film.	no
Which film has the director born later, The Secret Of The Blue Room or The Star Chamber?	[Final Answer]: The Secret Of The Blue Room	The Star Chamber
Which film has the director who died later, Swarg Narak or Antardhan?	[Final Answer]: Swarg Narak	Swarg Narak
Which film has the producer who was born earlier, Term Life or Housefull 2?	[Final Answer]: Term Life	Housefull 2
Which film was released more recently, Marriage License? or Maalgudi Days?	[Final Answer]: Maalgudi Days.	Maalgudi Days
Which film whose director was born first, Sword Of The Empire or Seven Guns For Timothy?	[Final Answer]: Sword Of The Empire	Sword Of The Empire
Which film has the director who died later, The Mystic Masseur or Butter Fingers?	[Final Answer]: The Mystic Masseur	The Mystic Masseur
Who is John Of Hesse-Braubach's co-husband?	[Final Answer]: Johannetta of Sayn-Wittgenstein	John George I, Duke of Saxe-Eisenach
Where does the director of film All For Love (2012 Film) work at?	[Final Answer]: Jiang Ping	China University of Political Science and Law
Which film was released more recently, The Master Man or Ashokavanam?	[Final Answer]: The Master Man	Ashokavanam
Which film has the director died later, Rhythm In The Clouds or September Affair?	[Final Answer]: Rhythm In The Clouds	Rhythm In The Clouds
Where was the place of burial of Nebetah's mother?	[Final Answer]: Mount Washington Cemetery, Independence Missouri.	KV35
Where was the place of death of George Of Lencastre, 2Nd Duke Of Aveiro's father?	[Final Answer]: Cadiz	Coimbra
Who is Duchess Marie Louise Of Mecklenburg-Schwerin's paternal grandfather?	[Final Answer]: Frederick Louis, Hereditary Grand Duke of Mecklenburg-Schwerin	Frederick Francis I, Grand Duke of Mecklenburg-Schwerin
Who lived longer, Lydia Knott or Maria Dulębianka?	[Final Answer]: Lydia Knott lived longer than Maria Dulębianka. Lydia Knott lived from 1866 to 1955, while Maria Dulębianka lived from 1861 to 1919.	Lydia Knott
What is the place of birth of Princess Raiyah Bint Hussein's father?	[Final Answer]: Amman	Amman
Which film has the director who is older, The Gentle Sex or The Searchers?	[Final Answer]: The Searchers	The Gentle Sex
Where did the director of film Torrid Zone die?	[Final Answer]: Paris	New York
What nationality is Horace Seymour's father?	[Final Answer]: British	Great Britain
Which country the performer of song That'S Good, That'S Bad (Frankie Laine Song) is from?	[Final Answer]: United States	America
Where was the composer of film Post Master born?	[Final Answer]: The information does not state where the composer of Post Master was born.	Karnataka
Where was the place of death of Carl Gustaf Creutz's father?	[Final Answer]: Kopparberg County	Öland
Where was the director of film Outlaw: The Saga Of Gisli born?	[Final Answer]: Reykjavík	Reykjavík
Who is Ermengarde Of Tuscany's paternal grandfather?	[Final Answer]: Bertha of Lotharingia	Adalbert I, Margrave of Tuscany
Which country the director of film Ata Pata Laapata is from?	[Final Answer]: India.	Indian
Where was the wife of Jesús Aguirre born?	[Final Answer]: Liria Palace in Madrid	Liria Palace
Who is the paternal grandmother of Princess Louise Of Denmark (1726–1756)?	[Final Answer]: Louise of Mecklenburg-Strelitz	Louise of Mecklenburg-Güstrow
What is the award that the performer of song In My Mind (Heather Headley Song) got?	[Final Answer]: Grammy Award for Best Contemporary R&B Gospel Album	Tony Award for Best Actress in a Musical
Which film has the director died later, El Túnel 6 or A Life At Stake?	[Final Answer]: El Túnel 6	El Túnel 6
What nationality is the composer of song Inescapable (Song)?	[Final Answer]: American.	American
Which film was released earlier, Rocky'S Knife or Buscando A Miguel?	[Final Answer]: Rocky's Knife	Rocky'S Knife
Which film whose director is younger, Daar Doer In Die Bosveld or Return Of Halleluja?	[Final Answer]: Daar Doer In Die Bosveld	Return Of Halleluja
Where was the place of burial of Adèle Hugo's father?	[Final Answer]: Mount Washington Cemetery, Independence Missouri.	Panthéon
Where was the father of Prabhu (Actor) born?	[Final Answer]: Chennai	Villupuram
Who is Princess Franziska Of Hohenlohe-Waldenburg-Schillingsfürst's sibling-in-law?	[Final Answer]: Archduke Maximilian Eugen of Austria.	Charles I of Austria
Who lived longer, Gustav Philipp Mörl or Giuseppe Diotti?	[Final Answer]: Gustav Philipp Mörl lived longer than Giuseppe Diotti. Gustav Philipp Mörl died in 1750, while Giuseppe Diotti died in 1846.	Gustav Philipp Mörl
When did Jacob Van Huysum's father die?	[Final Answer]: 1716	April 23, 1716
Who died later, George Grenfell-Baines or Veit Amerbach?	[Final Answer]: George Grenfell-Baines	George Grenfell-Baines
Who lived longer, Andrzej Markowski or François Missoffe?	[Final Answer]: Andrzej Markowski	François Missoffe
Who was born earlier, Elmer W. Conti or Seth Joshua?	[Final Answer]: Seth Joshua	Seth Joshua
When was Britannicus's father born?	[Final Answer]: 10 BC	1 August 10
Which film has the director who is older than the other, Lemming (Film) or Hunger For Love? 	[Final Answer]: Lemming	Hunger For Love
Who was born first, João De Aquino or Yacine Slatni?	[Final Answer]: João De Aquino	João De Aquino
Are The Pursuit Of Happiness (1934 Film) and East Lynne (1931 Film) from the same country?	"[Final Answer]: Yes. Both ""The Pursuit of Happiness"" (1934) and ""East Lynne"" (1931) were American films."	yes
Who was born first, Lamine Fomba or Michael Hagan?	[Final Answer]: Lamine Fomba	Michael Hagan
What is the place of birth of the director of film The New Kids?	[Final Answer]: Connecticut	New York
Which film was released earlier, It'S Never Too Late To Mend or The Bride'S Journey?	[Final Answer]: It'S Never Too Late To Mend	It'S Never Too Late To Mend
What nationality is Henry De Beaumont, 5Th Earl Of Warwick's father?	[Final Answer]: Norman	England
Who is the spouse of the director of film The Untouched Woman?	[Final Answer]: Karl Görge.	Käthe von Nagy
Which film has the director who was born later, I'Ll Take Sweden or His Majesty, The American?	[Final Answer]: I'll Take Sweden	I'Ll Take Sweden
Where was the place of death of the director of film The Iron Man (Serial)?	[Final Answer]: Los Angeles County, California.	Los Angeles County
What is the place of birth of the director of film Crazy Alien?	[Final Answer]: China	Taiyuan
Where was the place of death of Sancha Of Castile, Queen Of Navarre's mother?	[Final Answer]: Palencia	Palencia
Where does the director of film Shock Treatment (1964 Film) work at?	[Final Answer]: San Diego State University.	San Diego State University
Which film has the director who died earlier, Father Makes Good or The Power Of A Lie?	[Final Answer]: Father Makes Good	The Power Of A Lie
Which film came out earlier, Rajapart Rangadurai or At Sword'S Edge?	[Final Answer]: Rajapart Rangadurai.	At Sword'S Edge
Where did the director of film Saadia (Film) graduate from?	[Final Answer]: Harvard	Harvard
Which film has the director born later, The Last Company or Anand Ashram?	[Final Answer]: The Last Company	Anand Ashram
Where does Princess Rym Al-Ali's father work at?	[Final Answer]: Lakhdar Brahimi was former Algerian Minister for Foreign Affairs and senior UN official.	United Nations
Who was born later, Saulo Torón Navarro or Jim Sterling?	[Final Answer]: Saulo Torón Navarro	Jim Sterling
Who is older, Adam Quick or Vicente Costa?	[Final Answer]: Adam Quick	Vicente Costa
Who was born first, Marie-Eugène De L'Enfant-Jésus or Kenneth Johnson (Filmmaker)?	[Final Answer]: Marie-Eugène De L'Enfant-Jésus	Marie-Eugène De L'Enfant-Jésus
What is the place of birth of Damo (Philosopher)'s father?	[Final Answer]: Pythagoras of Samos	Samos
Which film has the director who is older, Shootin' For Love or The Other Life Of Captain Contreras?	[Final Answer]: Shootin' For Love	Shootin' For Love
Which film has the director who died later, Panam Paduthum Padu or Secret Enemies?	[Final Answer]: Panam Paduthum Padu	Panam Paduthum Padu
Do both films, They Didn'T Know and North Of The Border (Film), have the directors who are from the same country?	[Final Answer]: Yes, both films, “They Didn’t Know” and “North of the Border” have the same director, Herbert Smith.	no
Which country David Barclay Of Cheapside's father is from?	[Final Answer]: Scotland	America
Which film has the director born later, Gene Autry And The Mounties or Sunday'S Illness?	[Final Answer]: Sunday's Illness	Sunday'S Illness
What is the place of birth of Bea Ballard's father?	[Final Answer]: novelist J. G. Ballard.	Shanghai
Which film has the director who died earlier, Love That Brute or Laughing Heirs?	[Final Answer]: Love That Brute	Laughing Heirs
Who is the spouse of the director of film The Second Awakening Of Christa Klages?	[Final Answer]: Margarethe von Trotta	Volker Schlöndorff
Who is the maternal grandfather of Edmund Stafford, 5Th Earl Of Stafford?	[Final Answer]: John Bourchier, 1st Baron Berners	Thomas de Beauchamp
Who is William Paulet, 4Th Marquess Of Winchester's paternal grandmother?	[Final Answer]: Elizabeth Capel.	Elizabeth Willoughby
Where was the place of burial of Lucy Beall Candler Owens Heinz Leide's father?	[Final Answer]: Independence Missouri.	Georgia
Where was the director of film Inconceivable (2008 Film) born?	[Final Answer]: Northern Ireland.	Northern Ireland
Which film has the director who was born first, Bhavesh Joshi Superhero or Hellboy Ii: The Golden Army?	[Final Answer]: Bhavesh Joshi Superhero	Hellboy Ii: The Golden Army
Which film has the director who is older, Space Probe Taurus or Tom Mix In Arabia?	[Final Answer]: Space Probe Taurus	Tom Mix In Arabia
Which country Şehzade Ömer Hilmi's father is from?	[Final Answer]: Ottoman Empire	Ottoman Empire
Which country the director of film Shocking Asia Ii: The Last Taboos is from?	[Final Answer]: Germany	Austria
Which film has the director born first, The Bong Connection or The Whole Shootin' Match?	[Final Answer]: The Bong Connection.	The Whole Shootin' Match
Where was the performer of song Rewind (Find A Way) born?	[Final Answer]: Wales	Wolverhampton
Who is Anne De Laval, Viscountess Of Thouars's paternal grandfather?	[Final Answer]: Guy IX de Laval	Jean de Laval
Which film has the director born later, La Soif De L'Or or Forelsket I København?	[Final Answer]: La Soif De L'Or	Forelsket I København
Which film was released more recently, In The Country Of Juliets or Requiem For A Dream?	[Final Answer]: Requiem For A Dream.	Requiem For A Dream
Who is older, Boris Mavashev or Geraldo Vandré?	[Final Answer]: Boris Mavashev.	Geraldo Vandré
Who is younger, Lo Hsiao-Ting or Basil Hoffman?	[Final Answer]: Lo Hsiao-Ting	Lo Hsiao-Ting
Which film was released first, Sunset In Naples or The Storm Rider?	[Final Answer]: Sunset In Naples	Sunset In Naples
Are Ding Yaping and Johann Christian Gustav Lucae of the same nationality?	[Final Answer]: No. Ding Yaping is Chinese, while Johann Christian Gustav Lucae was German.	yes
Which film has the director who was born earlier, All About Anna or Spy Today, Die Tomorrow?	[Final Answer]: All About Anna	Spy Today, Die Tomorrow
Who was born first out of Marco Donadel and Carrie Finlay?	[Final Answer]: Marco Donadel	Marco Donadel
Where was the composer of song Unravel born?	[Final Answer]: Iceland	Reykjavík
Where was the director of film Meet Me On Broadway born?	[Final Answer]: New York, New York.	New York
Where did Carlos Bee's father die?	[Final Answer]: San Antonio, Texas.	San Antonio
Where was the father of Eugene Fubini born?	[Final Answer]: Venice	Venice
Who is Alberic Ii Of Spoleto's maternal grandmother?	[Final Answer]: Marozia	Theodora
Which film was released more recently, An Unreasonable Man or Lay The Favorite?	[Final Answer]: Lay The Favorite	Lay The Favorite
What nationality is Ameena Begum's husband?	[Final Answer]: Bangladeshi.	Indian
Who was born later, Paolo Marcellini or Dean Evans?	[Final Answer]: Paolo Marcellini	Dean Evans
Who is the paternal grandfather of Alexandru Coconul?	[Final Answer]: Radu Mihnea	Mihnea Turcitul
Where was the place of death of the director of film Judith Therpauve?	[Final Answer]: The information does not state where the director of film Judith Therpauve died.	Paris
Who was born later, Richard Longstreth or Jenny Algelid-Bengtsson?	[Final Answer]: Richard Longstreth	Jenny Algelid-Bengtsson
Who is the father of Auguste-Théodore-Paul De Broglie?	[Final Answer]: Achille-Victor, Duc de Broglie	Victor de Broglie
Which film has the director died first, Face In The Rain or Above The Rim?	[Final Answer]: Face In The Rain	Face In The Rain
Who is the mother-in-law of Maria Caroline Gibert De Lametz?	[Final Answer]: Florestan I	Louise d'Aumont
Where was the place of death of the director of film Foma Gordeyev (Film)?	[Final Answer]: The information does not state where Foma Gordeyev died.	Moscow
Which film was released earlier, The Pride And The Passion or Lamhe?	[Final Answer]: Lamhe	The Pride And The Passion
Are Sand River (Limpopo) and Dennis Creek both located in the same country?	[Final Answer]: Yes	no
What is the place of birth of the performer of song Outta My Head (Leona Lewis Song)?	[Final Answer]: London Borough of Islington, London.	London
Which film has the director died earlier, The Stolen Airship or Day Of The Badman?	[Final Answer]: The Stolen Airship.	Day Of The Badman
Which film whose director is younger, Kiladigalu or He'S My Girl?	[Final Answer]: Kiladigalu	Kiladigalu
Which award the performer of song In 20-0-3 earned?	[Final Answer]: Filmfare award in the best lyrics category	Grammy
Was Lupe Anguiano or Philippe Close born first?	[Final Answer]: Lupe Anguiano.	Lupe Anguiano
Which film was released earlier, Yohan: The Child Wanderer or A Nightmare On Elm Street 4: The Dream Master?	[Final Answer]: Yohan: The Child Wanderer	A Nightmare On Elm Street 4: The Dream Master
Which film came out first, The Greatest Thing In Life or Den Of Lions?	[Final Answer]: The Greatest Thing In Life	The Greatest Thing In Life
Who died earlier, Samson Occom or Imre Wampetich?	[Final Answer]: Samson Occom	Samson Occom
Who is the mother-in-law of Ada Of Scotland?	[Final Answer]: Floris III, Count of Holland.	Sophia of Rheineck
Where was the director of film Driftwood (2006 Film) born?	[Final Answer]: Tim Sullivan	Plainfield
Which magazine was published first, Graphotism or Amiga World?	[Final Answer]: Graphotism	Amiga World
Which film has the director who was born earlier, Khud-Daar or Murderer In The Fog?	[Final Answer]: Khud-Daar	Murderer In The Fog
Where was the place of death of the composer of song Bidin' My Time?	[Final Answer]: Hollywood	Hollywood
Do both Those Merry Souls and The Last Starfighter films have the directors from the same country?	"[Final Answer]: Yes. Both ""Those Merry Souls"" and ""The Last Starfighter"" films have directors from the same country, Hong Kong. Lau Kar-wing directed ""Those Merry Souls"" and Nick Castle directed ""The Last Starfighter""."	no
Which film has the director died first, Mandela And De Klerk or The Bride Came C.O.D.?	[Final Answer]: The Bride Came C.O.D. William Jackson Keighley died first.	The Bride Came C.O.D.
Who was born first, Botir Qoraev or István Ujhelyi?	[Final Answer]: Botir Qoraev	István Ujhelyi
Which film has the director died earlier, Miracle Of Marcelino or The Accompanist?	[Final Answer]: Miracle Of Marcelino	Miracle Of Marcelino
Which film has the director born earlier, Step Into Liquid or Seasons Of Our Love?	[Final Answer]: Step Into Liquid	Seasons Of Our Love
Who is Louis X Of France's maternal grandfather?	[Final Answer]: Philip IV	Henry I of Navarre
Who is the spouse of the performer of song Missing My Baby?	[Final Answer]: A.B. Quintanilla	Chris Pérez
Where was the place of death of Nancy Kassebaum's father?	[Final Answer]: Topeka, Kansas.	Topeka
Which film has the director who was born later, Light In The High Plains or On A Half Clear Morning?	[Final Answer]: Light In The High Plains	On A Half Clear Morning
Where was the father of David Ogilvy, 12Th Earl Of Airlie born?	[Final Answer]: Florence, Italy.	Florence, Italy
Which film has the director died earlier, The Marriage Of Maria Braun or An Ache In Every Stake?	[Final Answer]: The Marriage Of Maria Braun. Rainer Werner Fassbinder died in 1982, while Del Lord died in 1970.	An Ache In Every Stake
Which film has the director who was born first, Wild Harvest or Thunder In The Night?	[Final Answer]: Wild Harvest	Thunder In The Night
Who is younger, Jack Mildren or Alf Hellevik?	[Final Answer]: Jack Mildren	Jack Mildren
Which film has the director who died first, The Amsterdam Kill or A Boy From Calabria?	[Final Answer]: The Amsterdam Kill	The Amsterdam Kill
Who is Shepseskare's paternal grandmother?	[Final Answer]: Sahure	Khentkaus II
What is the place of birth of Clodia Pulchra (Wife Of Octavian)'s mother?	[Final Answer]: Appius Claudius Pulcher	Roman
Which film has the director who was born earlier, The Rise And Rise Of Michael Rimmer or Bar 51?	[Final Answer]: The Rise And Rise Of Michael Rimmer. Kevin Billington, the director of The Rise and Rise of Michael Rimmer, was born in 1934, while Amos Guttman, the director of Bar 51, was born in 1954.	The Rise And Rise Of Michael Rimmer
Why did Charis Wilson's husband die?	[Final Answer]: The provided text does not state why Helen Charis Wilson’s husband died. It only states her birth and death dates.	Parkinson's disease
Which film has the director born earlier, The Story Of Anastasia or A Mother Of Men?	[Final Answer]: The Story Of Anastasia	A Mother Of Men
When is Luke Dillon, 4Th Baron Clonbrock's father's birthday?	[Final Answer]: 29 March 1807	29 March 1807
Who is the father of the director of film Lila & Eve?	[Final Answer]: Charles Stone III	Chuck Stone
Where was the director of film The Hobbit: An Unexpected Journey born?	[Final Answer]: New Zealand.	Wellington
Who is the paternal grandfather of Princess Catherine Of Schleswig-Holstein-Sonderburg-Beck?	[Final Answer]: Duke Peter August of Holstein-Beck	Frederick Louis
Where does William Henry Fitzhugh Lee's father work at?	[Final Answer]: a senior Union command	Washington and Lee University
What is the award that the director of film Baltic Skies got?	[Final Answer]: Silver Prize	People's Artist of the RSFSR
What nationality is the director of film The Beach (Film)?	[Final Answer]: British.	British
Where was the place of burial of the director of film Tag Der Freiheit: Unsere Wehrmacht?	[Final Answer]: Munich Waldfriedhof.	Munich Waldfriedhof
Do the movies The Man Who Changed His Name (1928 Film) and The Lady Clare, originate from the same country?	[Final Answer]: Yes	yes
Which film has the director died earlier, Railroaded! or By The Light Of A Star?	[Final Answer]: Railroaded!	By The Light Of A Star
What nationality is the director of film Fúlmine?	[Final Answer]: Argentine	Spanish
Where was the performer of song When You Were My Girl born?	[Final Answer]: Southampton	Southampton
Are the movies Blood: The Last Vampire (2009 Film) and Jamesy Boy, from the same country?	[Final Answer]: No. Blood: The Last Vampire was released in Japan and the United Kingdom, while Jamesy Boy is an American film.	no
Which school was founded first, Catholic University Of Tachira or Sri Dharmaloka College?	[Final Answer]: Sri Dharmaloka College	Sri Dharmaloka College
Who is the paternal grandfather of Daughter Of Julius Constantius?	[Final Answer]: Julius Constantius	Constantius Chlorus
Who is the spouse of the director of film The Unholy Wife?	[Final Answer]: Rod Steiger	Maureen O'Sullivan
What is the place of birth of Gerard I, Count Of Guelders's wife?	[Final Answer]: Aquitaine	Luxembourg
Who is Bertrand, Count Of Toulouse's child-in-law?	[Final Answer]: Adelaide de Beziers	Cecile of France
Who is Charlotte Lee, Countess Of Lichfield's paternal grandmother?	[Final Answer]: Barbara Palmer, Duchess of Cleveland.	Henrietta Maria of France
Where was the place of death of Maria Of Jülich-Berg's mother?	[Final Answer]: Cologne	Kaster
Which film has the director who died earlier, Maravil Thirivu Sookshikkuka or The Wild Geese?	[Final Answer]: Maravil Thirivu Sookshikkuka	Maravil Thirivu Sookshikkuka
Where did Louisa Garrett Anderson's mother die?	[Final Answer]: Beaulieu-sur-Loire	Aldeburgh
Who is the paternal grandfather of William De Ferrers, 4Th Earl Of Derby?	[Final Answer]: William II de Ferrers, 4th Earl of Derby	Robert de Ferrers, 2nd Earl of Derby
When did William Ii Crispo's father die?	[Final Answer]: 1397	1397
What is the place of birth of the director of film Temptation Of A Monk?	[Final Answer]: Macau	Macau
Who is the father-in-law of Elizabeth Somerset, Baroness Herbert?	[Final Answer]: Charles Somerset, 1st Earl of Worcester	Henry Beaufort
Do both directors of films Sometimes Good and Sweet Sixteen (2002 Film) share the same nationality?	[Final Answer]: No. David Morris and Jacqui Morris directed Sometimes Good, while Ken Loach directed Sweet Sixteen (2002).	yes
Are Marufabad and Nasamkhrali both located in the same country?	[Final Answer]: Yes.	no
What is the date of death of Lancelot Lowther, 6Th Earl Of Lonsdale's father?	[Final Answer]: 11 March 1953	15 August 1876
Which film has more directors, Freaked or Tesis Sobre Un Homicidio?	[Final Answer]: Freaked	Freaked
What is the place of birth of the director of film Centaur (2016 Film)?	[Final Answer]: Sokuluk District, Kyrgyzstan.	Kyrgyzstan
What nationality is the director of film War Of The Buttons (1994 Film)?	[Final Answer]: Irish.	American
Who is Ferdinand, Duke Of Viseu's maternal grandfather?	[Final Answer]: Eleanor of Aragon	Ferdinand I
Which film has the director who was born later, The Night The Prowler or When The Gods Fall Asleep?	[Final Answer]: The Night The Prowler.	The Night The Prowler
Which film has the director who died earlier, Naa Mechida Huduga or The Countess Died Of Laughter?	[Final Answer]: Naa Mechida Huduga	The Countess Died Of Laughter
Where was the place of burial of the director of film Fear And Trembling (Film)?	[Final Answer]: Père Lachaise Cemetery.	Père Lachaise Cemetery
What is the place of birth of the director of film The Naked Island?	[Final Answer]: Hiroshima Prefecture	Hiroshima
Who is Eva Chamberlain's maternal grandmother?	[Final Answer]: Franz Liszt	Marie d'Agoult
What nationality of the company that published Personalized Medicine (Journal)?	[Final Answer]: United Kingdom	United Kingdom
Are both Lac À La Catin and Batiscan Lake (Quebec) located in the same country?	[Final Answer]: Yes	yes
Where was the director of film Suicide Commandos (Film) born?	[Final Answer]: Salsomaggiore Terme	Salsomaggiore Terme
Are the directors of films A South Sea Bubble and The Young Animals both from the same country?	[Final Answer]: Yes. Maury Dexter directed The Young Animals, which was filmed in Tucson, Arizona. T. Hayes Hunter directed A South Sea Bubble, which was filmed at Islington Studios. Both studios are in the United States.	yes
Who was born first, William L. Holland or Dale Vince?	[Final Answer]: William L. Holland	William L. Holland
Who is the spouse of the director of film The Dressmaker From Paris?	[Final Answer]: Paul Bern	Jean Harlow
Which film was released more recently, The Devil'S Rock or The Flyboys (Film)?	[Final Answer]: The Devil's Rock.	The Devil'S Rock
Which film was released more recently, Moscow Pride '06 or My Favourite Fabric?	[Final Answer]: My Favourite Fabric	My Favourite Fabric
Who was born earlier, Allen George Newman or James Dickson Phillips Jr.?	[Final Answer]: Allen George Newman	Allen George Newman
Which country Waleran De Beaumont, 1St Earl Of Worcester's father is from?	[Final Answer]: Normandy	England
Where was the performer of song Serial Killer (Song) born?	[Final Answer]: New York City	New York
Which film has the director died later, Pacific Rendezvous or Calling Bulldog Drummond?	[Final Answer]: Pacific Rendezvous	Pacific Rendezvous
Who was born first, Bogdan Țăruș or Robert Wulnikowski?	[Final Answer]: Bogdan Țăruș	Bogdan Țăruș
Who is Joan Of Valois, Countess Of Hainaut's paternal grandfather?	[Final Answer]: Charles, Count of Valois	Philip III of France
Who is younger, John Duncan Macfarlane or Andrés Manuel Del Río?	[Final Answer]: John Duncan Macfarlane	John Duncan Macfarlane
Are Ami Magazine and Spy (Magazine) from the same country?	[Final Answer]: No. Ami magazine is published in New York and Israel, while Spy magazine was based in New York City.	yes
Who was born earlier, Humphrey Edwardes-Jones or Ángel De La Torre?	[Final Answer]: Humphrey Edwardes-Jones	Ángel De La Torre
Who is Princess Marie Of Waldeck And Pyrmont's maternal grandfather?	[Final Answer]: Karl August, Prince of Waldeck.	William, Duke of Nassau
What is the date of death of Gustav Von Leonhard's father?	[Final Answer]: 23 January 1862	23 January 1862
Which film was released first, Insaaniyat or Five Of A Kind?	[Final Answer]: Insaaniyat	Five Of A Kind
Who is the father of the performer of song Come Dig Me Out?	[Final Answer]: Chris Ballew	Ozzy
Which film has the director born later, Per Amore... Per Magia... or All Wrong (Film)?	[Final Answer]: Per Amore... Per Magia...	Per Amore... Per Magia...
Which film has the director who was born earlier, The Affairs Of Martha or The Football Lottery?	[Final Answer]: The Affairs Of Martha	The Affairs Of Martha
Which film has the director born later, Ada Apa Dengan Cinta? or Adam & Paul?	[Final Answer]: Ada Apa Dengan Cinta?	Ada Apa Dengan Cinta?
What nationality is Krisztina Nyáry's husband?	[Final Answer]: Count Esterházy	Hungarian
Where was the place of burial of Yakov Dzhugashvili's mother?	[Final Answer]: Racha, in western Georgia.	Tiflis
What is the date of death of Alexander Baring, 4Th Baron Ashburton's father?	[Final Answer]: 6 September 1868	6 September 1868
Which film was released first, Koko And The Ghosts or Cheppave Chirugali?	[Final Answer]: Koko And The Ghosts	Cheppave Chirugali
Where did the director of film Hospitals: The White Mafia die?	[Final Answer]: Rome	Rome
Who is the paternal grandmother of Mervyn Tuchet, 4Th Earl Of Castlehaven?	[Final Answer]: Hubba bint Hulail	Lucy Mervyn
Where was the director of film The Making Of Plus One born?	[Final Answer]: Northern Ireland.	Northern Ireland
Which film whose director is younger, The Land Before Time Ix: Journey To Big Water or The Life Story Of David Lloyd George?	[Final Answer]: The Life Story Of David Lloyd George.	The Land Before Time Ix: Journey To Big Water
What is the place of birth of the director of film Bodily Harm (Film)?	[Final Answer]: Las Vegas, Nevada	New York
Who lived longer, Philippe Solari or Stephen Jurika?	[Final Answer]: Stephen Jurika	Stephen Jurika
Did the bands The Vaccines and The Wanted, originate from the same country?	[Final Answer]: Yes. Both The Vaccines and The Wanted originated from the United Kingdom.	yes
Where was the director of film The Snob Buster born?	[Final Answer]: Oklahoma City	Oklahoma City, Oklahoma
Who is Joan De Beauchamp, Countess Of Ormond's father-in-law?	[Final Answer]: James Butler, 9th Earl of Ormond and 2nd Earl of Ossory.	James Butler, 3rd Earl of Ormond
Who was born first out of Johan Jureskog and Kieren Jack?	[Final Answer]: Wesley Barresi	Johan Jureskog
What is the place of birth of the keyboardist of Veslefrekk?	[Final Answer]: Dombås	Dombås, Norway
Are Champagne For Caesar and A Million Ways To Die In The West from the same country?	[Final Answer]: Yes. A Million Ways to Die in the West and Champagne for Caesar are both from the United States. A Million Ways to Die in the West was filmed in New Mexico, and Champagne for Caesar was produced by Cardinal Pictures and released by United Artists, both based in the United States.	yes
Who lived longer, Neil Lloyd Macky or Domenico Cosselli?	[Final Answer]: Domenico Cosselli. Neil Lloyd Macky lived until 1981, while Domenico Cosselli died in 1855.	Neil Lloyd Macky
Where was the father of Baw Ngan-Mohn born?	[Final Answer]: Hanthawaddy	Martaban
Where was the performer of song Giati Fovase born?	[Final Answer]: Greece.	Tübingen
Which film has the director born first, Král Ulice or Brother Liu And Brother Wang On The Roads In Taiwan?	[Final Answer]: Král Ulice	Král Ulice
Which film has the director born earlier, Chaitrada Chandrama or Amelia Lópes O'Neill?	[Final Answer]: Sepideh Farsi	Amelia Lópes O'Neill
Are both Don Sasa and Boyd R. Overhulse from the same country?	[Final Answer]: No. Don Sasa is from American Samoa, while Boyd R. Overhulse is from Oregon.	yes
Who is the spouse of the director of film Paribar?	[Final Answer]: Euclid Tsakalotos.	Piya Sengupta
Who is Sobe (Sister Of Saint Anne)'s grandchild?	[Final Answer]: Elizabeth	John the Baptist
Which film has the director who died later, First-Year Student or Oru Sundariyude Katha?	[Final Answer]: First-Year Student	First-Year Student
Which film whose director is younger, Appointment With Murder or Big Business Girl?	[Final Answer]: Appointment With Murder.	Appointment With Murder
Where did Louis Of Nassau's mother die?	[Final Answer]: Stolberg	Dillenburg
What nationality is the director of film The Mexican Dream?	[Final Answer]: Venezuelan.	Venezuelan
Are Sydney Park (Actress) and Karl August Folkers of the same nationality?	[Final Answer]: Yes. Sydney Park is an American actress and Karl August Folkers was a Swedish lyric poet.	yes
Where did the composer of film Nighthawks (1981 Film) die?	[Final Answer]: Santa Monica, California	Santa Monica, California
Which film has the director died first, Crime Against Joe or Partners Three?	[Final Answer]: Crime Against Joe	Partners Three
Where did the director of film 1919 (Film) graduate from?	[Final Answer]: Trinity College, Oxford.	Trinity College, Oxford
Who is the paternal grandmother of Lewis Of Luxembourg?	[Final Answer]: Marguerite of Enghien	Mahaut de Châtillon
Who is the stepchild of Æthelred Of Mercia?	[Final Answer]: Ceolred	Oshere
Where does B. D. Hyman's mother work at?	[Final Answer]: B.D. Hyman’s mother, Bette Davis, was a film actress.	Warner Brothers
Where did the director of film No Sin On The Alpine Pastures (1950 Film) die?	[Final Answer]: Franz Antel died in Vienna.	Vienna
Did Dwight Harwood and Velvet (Singer) have the same nationality?	[Final Answer]: No. Dwight Harwood was American, while Velvet is a Swedish singer.	no
Where did the director of film Free Lips die?	[Final Answer]: Santa Barbara California	Santa Barbara
What is the place of birth of the director of film Breed Of The Border (1924 Film)?	[Final Answer]: Rochester, New York.	Rochester
Which film has the director died later, Hombisilu or O Sport, You Are Peace!?	[Final Answer]: O Sport, You Are Peace!	Hombisilu
When is the director of film The Red And The Blue (Film) 's birthday?	[Final Answer]: 2 July 1953	2 July 1953
Who is older, Kevin Hennessy or Emilia Bayer?	[Final Answer]: Kevin Hennessy	Emilia Bayer
Which film has the director who was born first, The Latin Immigrant or Racing Lady?	[Final Answer]: The Latin Immigrant	Racing Lady
Where was the place of death of Anna Of Saxe-Wittenberg's father?	[Final Answer]: Wittenberg	Celle
Where did the director of film Terminal Entry study?	[Final Answer]: Temple University	Temple University
Which film has the director born first, Betrayal From The East or The Magnificent Beast?	[Final Answer]: The Magnificent Beast	Betrayal From The East
Who is the father-in-law of Caroline Amalie Of Augustenburg?	[Final Answer]: Christian VIII	Frederick
Do both Dreams In A Drawer and Tifosi (Film) films have the directors from the same country?	"[Final Answer]: Yes, both ""Dreams In A Drawer"" and ""Tifosi"" films have directors from the same country, Italy. Renato Castellani directed ""Dreams In A Drawer"" and Neri Parenti directed ""Tifosi""."	yes
Which film has the director who died earlier, Moonlight And Pretzels or Husmandstøsen?	[Final Answer]: Moonlight And Pretzels	Husmandstøsen
Who is Philippe, Duke Of Anjou's maternal grandfather?	[Final Answer]: Louis XV of France.	Stanisław Leszczyński
What is the place of birth of the director of film Smile, Brother, Smile?	[Final Answer]: New York, New York	New York
Who is the paternal grandfather of Ray Knight (Rodeo Organizer)?	[Final Answer]: Jesse Knight	Newel Knight
Who is Zwelonke Sigcawu's paternal grandfather?	[Final Answer]: Xolilizwe Mzikayise Sigcawu.	Bungeni Zwelidumile Sigcawu
Where was the director of film Medal Of Honor (Film) born?	[Final Answer]: Petroșani	Petroșani
Where was the place of death of the composer of song The Old Master Painter?	[Final Answer]: Nashville, Tennessee	Nashville
Who is Rani Mukerji's father-in-law?	[Final Answer]: Aditya Chopra	Yash Chopra
Who was born later, H. Hawkline or Jimmy Kennedy?	[Final Answer]: H. Hawkline	H. Hawkline
Where did the composer of song Let'S Call The Whole Thing Off die?	[Final Answer]: 1937	Hollywood
What is the place of birth of the director of film Crystal Nights?	[Final Answer]: Pireas	Athens
Which film has the director died later, The True Story Of Eskimo Nell or Flame Of Stamboul?	[Final Answer]: The True Story Of Eskimo Nell.	The True Story Of Eskimo Nell
Which film has the director born later, The Mystic Masseur or The Rewrite?	[Final Answer]: The Mystic Masseur	The Rewrite
When was the director of film Slap Her... She'S French born?	[Final Answer]: October 20, 1952	October 20, 1952
Are Hopen Church and Spind Church located in the same country?	[Final Answer]: Yes	yes
Do director of film Njaan and director of film Oorummadi Brathukulu share the same nationality?	[Final Answer]: No.	yes
Where did the composer of song The Shepherd On The Rock die?	[Final Answer]: Schubert died at the age of 31, the cause officially attributed to typhoid fever, but believed by some historians to be syphilis.	Vienna
Where was the place of death of the founder of Western Auto?	[Final Answer]: Kansas City, Missouri	California
Which school was opened first, Carlisle School or Triam Udom Suksa School?	[Final Answer]: Triam Udom Suksa School	Triam Udom Suksa School
What is the place of birth of the composer of film The Charming Young Lady (Film)?	[Final Answer]: Moravské Budějovice	Moravské Budějovice
Where did Beatrice Of Bohemia's husband die?	[Final Answer]: 7 December 1383	Brandenburg an der Havel
What is the place of birth of the director of film The Admirer?	[Final Answer]: Kishinev.	Kishinev
Who is Archduchess Maria Antonia Of Austria (1899–1977)'s maternal grandfather?	[Final Answer]: Leopold I	Carlos, Duke of Madrid
Where did the director of film Carbon (Film) study?	[Final Answer]: Pune	Film and Television Institute of India
What is the place of birth of the director of film The Merry Wives?	[Final Answer]: Hradec Králové	Hradec Králové
Who died later, Henry Norrström or Wilford Bacon Hoggatt?	[Final Answer]: Wilford Bacon Hoggatt	Henry Norrström
Where was the place of death of the composer of song Love Is Here To Stay?	[Final Answer]: Hollywood	Hollywood
Which film was released first, Failure To Launch or Mako: The Jaws Of Death?	[Final Answer]: Failure To Launch	Mako: The Jaws Of Death
Where does Bernhard Bielenstein's father work at?	[Final Answer]: linguist, folklorist, ethnographer, and theologian.	St. Petersburg Academy of Sciences
What is the place of birth of Frederick, Prince Of Hohenzollern's mother?	[Final Answer]: Heiligendamm, Mecklenburg-Schwerin	Zürich
Where was the place of death of the performer of song Northwest Passage (Song)?	[Final Answer]: Greater Cincinnati Airport	Greater Cincinnati Airport
Where was the director of film Pistol Whipped born?	[Final Answer]: Eindhoven	Dutch
Which country Roman Smoluchowski's father is from?	[Final Answer]: Poland	Austro-Hungarian Empire
Which film has the director who died later, Akhono Onek Raat or Bitter Rice?	[Final Answer]: Akhono Onek Raat	Akhono Onek Raat
Which film has the director died later, Five Deadly Venoms or Asthram?	[Final Answer]: Five Deadly Venoms	Asthram
Where did the director of film The Bride Came C.O.D. die?	[Final Answer]: Paris	New York
Where was the director of film Code Name: The Cleaner born?	[Final Answer]: Albuquerque, New Mexico.	Albuquerque, New Mexico
Which country the director of film The Notebooks Of Memory is from?	[Final Answer]: France	French
Which film was released first, Ryan'S Daughter or A Day At The Museum?	[Final Answer]: Ryan's Daughter	Ryan'S Daughter
Are Liverpool Boys High School and St Stephen'S School, Perth located in the same country?	[Final Answer]: Yes	yes
Do both directors of films Kangaroo Jack and Executive Action (Film) have the same nationality?	[Final Answer]: No. David McNally was born in Liverpool, England, while David Miller was born in America.	no
Which film whose director was born first, The Snake Brothers or Olympus Has Fallen?	[Final Answer]: The Snake Brothers	Olympus Has Fallen
Where did Sholto Douglas, 15Th Earl Of Morton's father study?	[Final Answer]: Cambridge	King's College
Who is the child-in-law of Marie De Namur?	[Final Answer]: Henry II, Graf of Vianden.	Otto, Lord of Arkel
Where did Princess Margarita Of Greece And Denmark's mother die?	[Final Answer]: Switzerland	Buckingham Palace
What is the place of birth of the director of film Tammy And The T-Rex?	[Final Answer]: Stewart Raffill	British
What is the place of birth of the director of film Winds Of The Pampas?	[Final Answer]: The place of birth of the director of Winds Of The Pampas is not explicitly stated in the provided text.	Italian
Where did the director of film What Rats Won'T Do die?	[Final Answer]: Stoke St Gregory, Somerset	Somerset
Who is the spouse of the director of film Vaishnavee?	[Final Answer]: Mano Nanayakkara	Lester James Peries
Which film has the director born later, A Little Like Drowning or That Woman?	[Final Answer]: A Little Like Drowning	That Woman
Where did the director of film Border (2018 Film) graduate from?	[Final Answer]: Royal Academy of Sciences in Stockholm.	National Film School of Denmark
Which film came out first, At Sword'S Edge or Crimson Gold?	[Final Answer]: At Sword’s Edge	At Sword'S Edge
Are Brian Part and John Mosca both from the same country?	[Final Answer]: No. Brian Part is from Los Angeles, California, and John Mosca is from Chicago Heights, Illinois.	yes
Are both Alex Bregman and Francesca Sterlacci from the same country?	[Final Answer]: No.	yes
What is the date of birth of Lord William Montagu-Douglas-Scott's father?	[Final Answer]: 17 January 1896	30 March 1864
Which film has the director who died first, Tex And The Lord Of The Deep or Henry Goes Arizona?	[Final Answer]: Tex And The Lord Of The Deep	Henry Goes Arizona
Which film whose director was born first, Swamp Women or Tracy Rides?	[Final Answer]: Swamp Women	Tracy Rides
Which film has the director born later, Home Alone 2: Lost In New York or Our Mother'S House?	[Final Answer]: Home Alone 2: Lost In New York. Chris Columbus was born in 1958, while Jack Clayton was born in 1921.	Home Alone 2: Lost In New York
Where was the place of death of the director of film Hitch Hike Lady?	[Final Answer]: Los Angeles	Los Angeles
Which one was established first, Windowswear or Compagnie Française Des Métaux?	[Final Answer]: Compagnie Française Des Métaux	Compagnie Française Des Métaux
Where was the husband of Katherine De Stafford born?	[Final Answer]: Michael de la Pole.	English
What is the date of death of Francisco De Benavides's father?	[Final Answer]: 1666	March 19, 1666
Who is Sir William Lowther, 1St Baronet, Of Marske's paternal grandfather?	[Final Answer]: Anthony Lowther	Robert Lowther
Was Prince Albert Hunt or Daniel Tauvry born first?	[Final Answer]: Daniel Tauvry was born first.	Daniel Tauvry
Who is the paternal grandfather of Conrad Ii Of Italy?	[Final Answer]: Henry IV	Henry III
Which film has the director died later, Taming Sutton'S Gal or Struggle For Eagle Peak?	[Final Answer]: Struggle For Eagle Peak	Taming Sutton'S Gal
Which film has the director who was born first, Cross Of Love or Ljuvlig Är Sommarnatten?	[Final Answer]: Cross Of Love	Cross Of Love
Which country the director of film Thundering Mountains is from?	[Final Answer]: Yugoslavia	Serbian
Where does the director of film L'Arbre, Le Maire Et La Médiathèque work at?	[Final Answer]: Éric Rohmer.	Cahiers du cinéma
Who is Teriimaevarua Iii's paternal grandmother?	[Final Answer]: Moe-a-Mai	Pōmare IV
Where was the place of burial of John Stafford, 1St Earl Of Wiltshire's father?	[Final Answer]: Hever Castle	Northampton
What is the date of death of Bolko V The Hussite's father?	[Final Answer]: 29 May 1460	6 May 1437
What is the place of birth of Gwladys's husband?	[Final Answer]: Brycheiniog	Gwynllwg
Who died first, Dominick Basso or Ilse Lehiste?	[Final Answer]: Dominick Basso	Dominick Basso
Who is the father-in-law of Rahmat Banu Begum?	[Final Answer]: Lachit Borphukan and Laluksola Borphukan.	Aurangzeb
Which film was released first, Mawali No.1 or Vous Êtes De La Police??	[Final Answer]: Mawali No.1	Mawali No.1
Who is the father of William Ii, Duke Of Bavaria?	[Final Answer]: Albert I	Albert I, Duke of Bavaria
Which film has the director who was born later, Common Clay (1919 Film) or I'M From The City?	[Final Answer]: Common Clay	I'M From The City
Which country the director of film Dika: Murder City is from?	[Final Answer]: United States.	American
What nationality is Pixie Geldof's father?	[Final Answer]: Irish	Irish
Are both The Trial Of Mary Dugan (1941 Film) and Undisputed (Film) from the same country?	[Final Answer]: No. The Trial Of Mary Dugan (1941 Film) is from the United States, while Undisputed (Film) is from the United States.	yes
Who is Queen Inseong's mother-in-law?	[Final Answer]: Queen Janggyeong	Queen Janggyeong
Do both My Friend From The Park and Punks (Film) films have the directors from the same country?	[Final Answer]: Yes. Ana Katz, the director of My Friend from the Park, was born in Buenos Aires, Argentina, while Patrik-Ian Polk, the director of Punks, was born in Hattiesburg, Mississippi, USA.	no
Which country the director of film Romanoff And Juliet (1961 Film) is from?	[Final Answer]: United States	United Kingdom
